21三体综合症	trisomy
996	9am–9pm
A片	pornography
G弦裤	G-string
G点	G-spot
O型腿	bow-leggedness
U型池	half-pipe
U形转弯	U-turn
X光	X-ray
coser	cosplayer
ins	Instagram
□	uptight
〇	zero
𪢌哰	incoherent
㞗	dick
㥯	cautious
㹴犬	terrier
䍃	pitcher
鳚	blenny
一不小心	accidentally
一些	some
一代	generation
一来	firstly
一侧化	lateralization
一元	univariate
一元论	monism
一共	altogether
一再	repeatedly
一动不动	motionless
一匙	spoonful
一半	half
一味	persistently
一尘不染	incorruptible
一夕	overnight
一夫一妻	monogamy
一夫多妻	polygamy
一字不差	verbatim
一定要	must
一对	couple
一对一	one-to-one
一层	layer
一己	oneself
一带	region
一打	dozen
一排	row
一本正经	deadpan
一秉虔诚	devoutly
一等一	first-rate
一节诗	stanza
一线微光	gleam
一致性	consistency
一贫如洗	penniless
一钱如命	penny-pinching
一长一短	long-winded
丁丁	Tintin
丁内酯	butyrolactone
丁加奴	Terengganu
丁字	T-shaped
丁字梁	T-girder
丁字街	T-junction
丁烷	butane
丁鲷	tench
七国集团	G7
七日热	leptospirosis
七旬老人	septuagenarian
七月份	July
七边形	heptagon
七项全能	heptathlon
丈夫	husband
丈母娘	mother-in-law
三倍	triple
三价	trivalent
三叉戟	trident
三味线	shamisen
三弦	sanxian
三得利	Suntory
三月份	March
三朋四友	friends
三氯蔗糖	sucralose
三洋	Sanyō
三田	Mita
三联管	triplet
三胞胎	triplets
三色堇	pansy
三菱	Mitsubishi
三叶虫	trilobite
三藏	Tripitaka
三角学	trigonometry
三角形	triangle
三角龙	triceratops
三资企业	foreign
三部曲	trilogy
三重	treble
三驾马车	troika
上品	top-quality
上层建筑	superstructure
上标	superscript
上网本	netbook
上艾瑟尔	Overijssel
上进心	ambition
上都	Shangdu
上龙	pliosaurus
下一次	next
下列	following
下坡	downhill
下巴	chin
下旋削球	golf
下水管	drainpipe
下水道	sewer
下画线	underline
下关市	Shimonoseki
下颔	mandible
下风方向	leeward
不丹	Bhutan
不来梅港	Bremerhaven
不值得	unworthy
不偏不倚	impartial
不停	incessant
不备	unprepared
不免	inevitably
不兼容性	incompatibility
不凡	extraordinary
不加区别	indiscriminate
不加拘束	unrestricted
不加掩饰	undisguised
不动摇	unmoved
不受欢迎	unwelcome
不可	cannot
不可侵犯权	inviolability
不可分离	inseparable
不可思议	unimaginable
不可收拾	unmanageable
不可数	uncountable
不可知论	agnosticism
不可磨灭	indelible
不可缺少	indispensable
不可置信	unbelievable
不可逆	irreversible
不可避	unavoidable
不可避免	unavoidably
不可靠	unreliable
不合作	noncooperation
不合理	unreasonable
不吉利	ominous
不吐气	unaspirated
不周延	undistributed
不堪忍受	unbearable
不妥协	uncompromising
不孝	unfilial
不完善	imperfect
不定词	infinitive
不容置疑	unquestionable
不实	untruthful
不已	incessantly
不带电	uncharged
不平衡	disequilibrium
不幸之事	mishap
不必要	needless
不情愿	unwilling
不想	unexpectedly
不慌不忙	unhurried
不拉叽	nasty
不明不白	dubious
不智	unwise
不朽	eternal
不正常	abnormal
不比	unlike
不毛	barren
不清	unclear
不凑巧	unluckily
不准确	imprecise
不溶	insoluble
不满意	dissatisfied
不由自主	involuntarily
不当	unsuitable
不相容	incompatible
不知不觉	unwittingly
不知何故	somehow
不确实	untrue
不稳性	instability
不结盟	nonalignment
不经意	carelessly
不义	injustice
不声不响	silent
不育性	sterility
不自然	unnatural
不舒适	uncomfortable
不要	don't!
不规则	irregular
不觉	unconsciously
不触目	unobtrusive
不言自明	self-evident
不调和	discord
不豫	displeased
不轨	errant
不透明	opaque
不逞之徒	desperado
不连续	discontinuous
不道德	immoral
不食人间烟火	otherworldly
不饱和	unsaturated
丕	grand
世仇	feud
世爵	Spyker
世界级	world-class
世界语	Esperanto
丘比特	Cupid
丘脑	thalamus
丘陵	hills
丙烯腈	acrylo-nitrile
丙烷	propane
丞	deputy
中介所	agency
中位数	median
中低端	mid-to-low-range
中俄	China-Russia
中南海	Zhongnanhai
中印	China-India
中和剂	neutralizer
中国	China
中国中心主义	Sinocentrism
中国城	Chinatown
中国海洋石油总公司	CNOOC
中土	Sino-Turkish
中子	neutron
中尼	China-Nepal
中层	middle-ranking
中式英语	Chinglish
中心	center
中心粒	centriole
中性	neutral
中意	Sino-Italian
中提琴	viola
中文标准交换码	CSIC
中板	moderato
中欧	Sino-European
中法	China-France
中波	Chinese-Polish
中流	midstream
中程	medium-range
中等	medium
中篇小说	novella
中继器	repeater
中美	China-USA
中肯	pertinent
中华龙鸟	Sinosauropteryx
中号	medium-sized
中西部	midwest
中转站	interchange
中途	midway
中都	Zhongdu
中间件	middleware
中间神经元	interneuron
中青年	middle-aged
中饭	lunch
串串狗	mutt
串串猫	moggy
丳	skewer
丸剂	pill
丹佛	Denver
丹尼索瓦人	Denisovan
丹麦	Denmark
主修	major
主嫌	prime
主导性	leadership
主席团	presidium
主教	bishop
主教座堂	cathedral
主机板	motherboard
主权	sovereignty
主犯	culprit
主管人员	executive
主裁判	umpire
主要	main
主观	subjective
主观主义	subjectivism
主词	subject
乀	stretch
幺点	ace
之上	above
之字形	Z-shaped
乍得	Chad
乍浦	Zhapu
乏味	tedious
乘客	passenger
乘数	multiplier
乘法	multiplication
乙种	beta-
乙醇	ethanol
九十	ninety
九层塔	basil
九旬老人	nonagenarian
九边形	nonagon
乞丐	beggar
也就是	i.e.
也许	perhaps
也门	Yemen
乳剂	emulsion
乳化剂	emulsifier
乳房摄影	mammography
乳果糖	lactulose
乳杆菌	lactobacillus
乳清	whey
乳白天空	whiteout
乳糖	lactose
乳腺炎	mastitis
乳胶	latex
乳贴	pasties
乳酪	cheese
乳头	nipple
乳头瘤	papilloma
乳香	frankincense
干梅子	prunes
干燥剂	desiccant
干草	hay
干贝	conpoy
干酪素	casein
乱七八糟	muddled
乱局	turmoil
乱掉	chaotic
乱民	rebels
亄	covetous
了然	evident
事事	everything
事件	incident
二来	secondly
二元论	dualism
二十	twenty
二十面体	icosahedron
二𫫇英	dioxin
二月份	February
二极管	diode
二氧化物	dioxide
二氯甲烷	dichloromethane
二甲苯	xylene
二硫基丙醇	dimercaprol
二糖	disaccharide
二级士官	sergeant
二维	two-dimensional
二苯氯胂	diphenylchloroarsine
二郎神	Erlangshen
二醇	glycol
二重唱	duet
互	mutual
互不侵犯	non-aggression
互操性	interoperability
互相依存	interdependent
互相连接	interlinked
互联	interconnected
互联网	Internet
互连	interconnection
五光十色	dazzling
五十	fifty
五十铃	Isuzu
五彩纸屑	confetti
五旬节	Pentecost
五月份	May
五棱镜	pentaprism
五角星	pentagram
五边形	pentagon
五项全能	pentathlon
井字棋	tic-tac-toe
井然	tidy
亚丁	Aden
亚利桑那	Arizona
亚原子	subatomic
亚单位	subunit
亚太	Asia-Pacific
亚急性	subacute
亚文化	subculture
亚松森	Asunción
亚格门农	Agamemnon
亚历山大里亚	Alexandria
亚比利尼	Abilene
亚特兰大	Atlanta
亚当	Adam
亚当斯	Adams
亚当斯敦	Adamstown
亚砷	arsenous
亚硝胺	nitrosamine
亚硝酸盐	nitrite
亚细亚	Asia
亚美尼亚	Armenia
亚临界	subcritical
亚该亚	Achaia
亚达薛西	Artaxerxes
亚铁	ferrous
亚马逊	Amazon
亚麻	flax
亚麻布	linen
亚麻籽	flaxseed
亟	anxiously
交叉感染	cross-infection
交叉火力	crossfire
交叉耐药性	cross-tolerance
交响乐	symphony
亦	also
亦或	or
亨格洛	Hengelo
享乐主义	hedonism
享乐主义者	hedonist
京哈	Beijing-Harbin
京东	Jingdong
京都	Kyoto
亭子	pavilion
亮度	brightness
亮饰	diamanté
亹	resolute
人儿	figurine
人力车	rickshaw
人参	ginseng
人口学	demography
人口数	population
人口普查	census
人口稠密	populous
人字形	V-shape
人工流产	abortion
人师	mentor
人心果	sapodilla
人文主义	humanism
人文学	humanities
人族	Hominini
人物描写	portrayal
人畜共患症	zoonosis
人群	crowd
人脉	contacts
人行横道	crosswalk
人行道	sidewalk
人质	hostage
人造丝	rayon
人造黄油	margarine
人类学	anthropology
人类学家	anthropologist
人体工学	ergonomics
什	what
什一奉献	tithing
什刹海	Shichahai
什么时候	when?
仇外心理	xenophobia
今日	today
今日头条	Toutiao
今晚	tonight
介绍信	reference
介词	preposition
仍然	still
仔猪	piglet
仗火	battle
付讫	paid
仙人掌	cactus
仙台	Sendai
仙子	fairy
代利斯	Dallys
代数	algebra
代尔夫特	Delft
代码	code
代词	pronoun
代金券	voucher
令人钦佩	admirable
令人发指	abhorrent
令状	writ
以人为本	people-oriented
以埃	Israel-Egypt
以太坊	Ethereum
以太网	Ethernet
以巴	Israeli-Palestinian
以弗所	Ephesus
以往	formerly
以叙	Israel-Syria
以色列	Israel
仰泳	backstroke
仲裁	arbitration
仵工	pallbearer
任何	any
任天堂	Nintendo
仿生	bionic
仿讽	parody
企求	desirous
企鹅	penguin
伊利埃斯库	Iliescu
伊势丹	Isetan
伊尼伊德	Aeneid
伊戈尔	Igor
伊拉克	Iraq
伊斯坦布尔	Istanbul
伊斯兰	Islam
伊朗	Iran
伊尔库茨克	Irkutsk
伊留申	Ilyushin
伋	unreal
伏羲	Fuxi
伏都教	Voodoo
休伊特	Hewitt
休惜	recess
休战	armistice
伯克利	Berkeley
伯利兹	Belize
伯恩茅斯	Bournemouth
伯明翰	Birmingham
伯尔尼	Bern
伯赛大	Bethsaida
估测	estimate
伴郎	groomsman
伶人	actress
似乎	seemingly
似雪	snowy
似鲴	Xenocyprioides
伽倻	Gaya
伽利略号	Galileo
但是	but
位元币	Bitcoin
位形	configuration
低三下四	servile
低俗化	vulgarization
低地	lowland
低平火山口	maar
低息	low-interest
低眉顺眼	docile
低洼	low-lying
低端	low-end
低等	inferior
低语	mutter
低音	bass
低音喇叭	woofer
低音大提琴	contrabass
低音炮	subwoofer
住友	Sumitomo
住址	address
住房	housing
佐世保	Sasebo
佐治亚	Georgia
佐罗	Zorro
佑护	blessing
占领者	occupant
何人	who
何方	where?
何时	when
佛手瓜	choko
佛教	Buddhism
佛教徒	Buddhist
佛法僧目	Coraciiformes
佛罗里达	Florida
作物	crop
作者	author
作证能力	competence
作马	sawhorse
你好	hello
佣金	commission
佩奇	Peppa
佳绩	success
佸	meet
使人信服	convincing
使徒	apostle
来客	guest
例外字	exceptions
侍应生	waiter
侍卫官	guard
供应品	supplies
供应商	supplier
依地酸二钴	kelocyanor
依属	dependence
依序	sequentially
依撒意亚	Isaiah
侯爵	marquis
侵权行为	tort
侵略者	aggressors
侵蚀作用	erosion
便利性	convenience
便士	penny
便帽	cap
便携式	portable
便民	user-friendly
便车旅行者	hitch-hiker
促进	boost
俄中	Russia-China
俄亥俄	Ohio
俄勒冈	Oregon
俄乌	Russo-Ukrainian
俄狄浦斯	Oedipus
俄罗斯	Russia
俊雅	graceful
俘虏	captive
俚语	slang
保人	guarantor
保加利亚	Bulgaria
保守主义	conservatism
保安族	Bao'an
保密性	secrecy
保温瓶	thermos
保洁	sanitation
保洁箱	litter-bin
保皇党	royalists
保真度	fidelity
保罗	Paul
保护主义	protectionism
保护国	protectorate
保护性	protective
保护者	protector
保镖	bodyguard
保障监督	safeguards
保险人	insurer
信差	messenger
信徒	believer
信息图	infographic
信息技术	IT
信息素	pheromone
信札	letter
信物	keepsake
信号	signal
信靠	trust
修指甲	manicure
修正主义	revisionism
修脚	pedicure
修脚师	pedicurist
修补匠	tinker
修道士	friar
俯卧撑	push-up
俳句	haiku
俸	stipend
俾格米	Pygmy
仓鼠	hamster
个人主义	individualism
个人电脑	PC
个体	individual
倍儿	really
倒位	inversion
倒着	backwards
倒角	chamfer
倔	gruff
幸存者	survivor
借代	metonymy
借译词	calque
倦	tired
伦敦	London
伦理	ethics
假性	pseudo-
假性近视	pseudomyopia
假惺惺	phony
假掰	pretentious
假期	vacation
假球	match-fixing
假设性	hypothetical
假设语气	subjunctive
假说	hypothesis
假象牙	celluloid
假释	parole
假体	implant
假发	wig
伟晶岩	pegmatite
偏执狂	paranoia
偏瘫	hemiplegia
偏颇	biased
偏头痛	migraine
偏黄	yellowish
做不到	impossible
停尸房	mortuary
停尸间	morgue
健力	powerlifting
健友	gym-goer
健忘	forgetful
健忘症	amnesia
健美运动	body-building
健身房	gym
侧记	sidelight
侦察性	investigatory
偶像	idol
偶合	coincidence
偷偷摸摸	sneaky
偷摸	surreptitious
偷猎者	poacher
伪代码	pseudocode
伪君子	hypocrite
伪善	hypocritical
伪科学	pseudoscience
伪纪录片	mockumentary
伪证	perjury
伪造者	forger
杰作	masterpiece
杰米	Jim
伞兵	paratrooper
伞形	umbrella-shaped
伞菌	agaric
备份	backup
催乳激素	prolactin
催化作用	catalysis
催化剂	catalyst
催泪剂	lachrymator
催产素	oxytocin
催眠	hypnosis
傮	finish
傲慢无礼	disrespectful
传呼机	pager
传单	leaflet
传感器	sensor
传教士	missionary
传染病学	epidemiology
传真电报	phototelegram
传闻	rumor
传声器	microphone
传道部	mission
伛	hunchbacked
债权人	creditor
债款	debt
伤寒	typhoid
傻	foolish
傻愣愣	petrified
傻瓜式	foolproof
傻眼	dumbfounded
傻头傻脑	muddle-headed
倾听者	listener
偻	crookbacked
佥	all
働	work
像片	photo
像素	pixel
侨民	expatriates
仆人	servant
僧侣	monk
僵住症	catalepsy
僵硬	stiff
价钱	price
仪式	ceremony
亿万富豪	multimillionaire
俭省	thrifty
儒教	Confucianism
儒艮	dugong
优胜	superior
优惠券	coupon
优步	Uber
优生学	eugenics
优异	exceptional
优秀	outstanding
优衣库	Uniqlo
优游自得	unfettered
优酷	Youku
储物柜	locker
兀自	yet
元帅	commander-in-chief
元数据	metadata
元气	vigor
元组	tuple
元认知	metacognition
元语言	metalanguage
元音	vowel
兄弟会	fraternity
充沛	abundant
充满阳光	sun-drenched
兆瓦	megawatt
兆瓦时	megawatt-hour
兆赫	megahertz
凶犯	murderer
凶神恶煞	devils
先例	precedent
先兆	omen
先前	before
先天性	congenital
先有	prior
先民	forebears
先决	prerequisite
先决条件	precondition
先烈	martyr
先秦	pre-Qin
先声	herald
先行者	forerunner
先见之明	foresight
先锋	vanguard
先锋派	avant-garde
先驱者	pioneer
光刻	photolithography
光化学	photochemistry
光合作用	photosynthesis
光学	optics
光年	light-year
光敏	photosensitive
光滑	glossy
光照	illumination
光环	halo
光磁	magneto-optical
光秃秃	bald
光芒万丈	splendor
光谱	spectrum
光谱图	spectrogram
光谱学	spectroscopy
光遗传学	optogenetics
光电	photoelectric
光电二极管	photodiode
光电子	photoelectron
光头党	skinheads
克什米尔	Kashmir
克利夫兰	Cleveland
克孜尔尕哈	Kizilgaha
克拉斯诺亚尔斯克	Krasnoyarsk
克拉科夫	Krakow
克尔白	Ka'aba
克罗地亚	Croatia
克苏鲁	Cthulhu
克虏伯	Krupp
克里米亚	Crimea
克雷伯氏菌属	Klebsiella
免息	interest-free
免疫力	immunity
免疫学	immunology
免疫法	immunization
免责声明	disclaimer
免费软件	freeware
儿媳	daughter-in-law
儿子	son
儿科	pediatrics
儿马	stallion
兔	rabbit
兔斯基	Tuzki
兜帽	hood
入侵者	intruder
入围者	finalist
入微	thoroughgoing
入时	fashionable
入海口	estuary
内啡肽	endorphin
内存储器	RAM
内布拉斯加	Nebraska
内涵意义	connotation
内涝	waterlogged
内窥镜	endoscope
内置	built-in
内罗毕	Nairobi
内臣	chamberlain
内华达	Nevada
内衣裤	underwear
内部网	intranet
内酯	lactone
内陆	inland
全国性	national
全场一致	unanimous
全天候	all-weather
全局性	global
全心全意	wholeheartedly
全息	holographic
全栈	full-stack
全民公决	referendum
全球化	globalization
全球而言	globally
全素食	vegan
全般	entire
全部	whole
全体人员	crew
两星期	fortnight
两样	different
两用	dual-use
两重	dual
八	eight
八倍体	octoploid
八字脚	splayfoot
八度	octave
八廓	Barkhor
八强赛	quarterfinals
八月份	August
八爪鱼	octopus
八角枫	alangium
八进制	octal
八达岭	Badaling
八边形	octagon
八开	octavo
八面体	octahedron
公丈	decameter
公主	princess
公允	equitable
公克	gram
公两	hectogram
公共	public
公升	liter
公司行号	businesses
公式	formula
公引	hectometer
公德心	civility
公斗	decaliter
公会	guild
公正	just
公民	citizen
公爵夫人	duchess
公牛	bull
公社	commune
公秉	kiloliter
公称	nominal
公义	righteousness
公猪	boar
公鸡	cock
公顷	hectare
六价	hexavalent
六分仪	sextant
六方	hexagonal
六月份	June
六芒星	hexagram
六边形	hexagon
六面体	hexahedron
共享软体	shareware
共同体	community
共和国	republic
共形	conformal
共时	synchronic
共济会	Freemasonry
共犯	accomplice
共生	symbiosis
共产主义	communism
共谋罪	conspiracy
共谋者	conspirator
共轭	math.
兵棋推演	war-gaming
兵队	troops
其实	actually
具体	concrete
典狱长	warden
典雅	refined
兼容	compatible
兼容性	compatibility
册历	diary
再不	alternatively
再处理	reprocessing
冒犯者	offender
冒纳罗亚	Moanalua
冒险者	adventurer
冗繁	miscellaneous
冗赘	verbose
冗长辩论	filibuster
冠状病毒	coronavirus
冠军	champion
冠军赛	championship
冤假错案	unjust
冤种	dupe
冬季	winter
冬蛰	hibernation
冬青	holly
冰上运动	ice-sports
冰凝器	cryophorus
冰塔	serac
冰屋	igloo
冰岛	Iceland
冰川	glacier
冰帽	icecap
冰晶石	cryolite
冰柱	icicle
冰柜	freezer
冰毒	methamphetamine
冰凉	ice-cold
冰爪	crampon
冰片	borneol
冰窖	icehouse
冰镇	iced
冶天	ATI
冶金学	metallurgy
冷	cold
冷冷	coldly
冷冽	chilly
冷却剂	coolant
冷厉	stern
冷水机组	chiller
冷知识	trivia
冷轧	cold-rolling
冷酷	unfeeling
冷酷无情	cold-hearted
冷飕飕	chilling
准将	commodore
凊	cool
凌乱	messy
凌志	Lexus
冻伤	frostbite
凝固汽油弹	napalm
凝液	condensate
凝胶	gel
凝花菜	gelidiella
凝血酶原	prothrombin
凡是	every
凯尼恩	Canyon
凯歌	paean
凯法劳尼亚	Kefalonia
凯尔特人	Celt
凯迪拉克	Cadillac
凯达格兰	Ketagalan
凵	receptacle
凶暴	brutal
凶残	savage
凸性	convexity
凸缘	flange
凸轮	cam
凸轮轴	camshaft
凹	concave
凹凸形	crenelated
凹凸有致	curvaceous
凹凸轧花	embossing
凹度	concavity
凹陷	hollow
出乎预料	unexpected
出入口	gateway
出席者	attendee
出版商	publisher
出版物	publications
出生地	birthplace
出色	remarkable
出血性	hemorrhagic
凼肥	manure
刀剑	sword
刀斧手	lictor
刀叶	blade
刀鞘	scabbard
分布式	distributed
分光光度法	spectrophotometry
分光计	spectrometer
分克	decigram
分册	fascicle
分升	deciliter
分局	sub-bureau
分属	classification
分岔	bifurcation
分形	fractal
分会场	sub-venues
分析器	analyzer
分水线	watershed
分泌物	secretion
分瓦	deciwatt
分生组织	meristem
分站	substation
分节	segmented
分米	decimeter
分裂主义	separatism
分解作用	decomposition
分贝	decibel
分销商	distributor
分镜	storyboard
分钟	minute
分离分子	separatist
切分音	syncopation
切实可行	feasible
切尔诺贝利	Chernobyl
切韵	Qieyun
刈	mow
刊物	publication
列克星顿	Lexington
列宁主义	Leninism
列支敦士登	Liechtenstein
初潮	menarche
别人	others
别克	Buick
别致	unusual
别处	elsewhere
别号	alias
刨子	plane
刨齿	gear-shaping
利他主义	altruism
利伯曼	Liberman
利古里亚	Liguria
利奈唑胺	Linezolid
利尿剂	diuretic
利己主义	egoism
利比亚	Libya
利比里亚	Liberia
利润	profits
利兹	Leeds
利宾纳	Ribena
利马	Lima
利默里克	Limerick
刮铲	scraper
刮胡刀	razor
到处	everywhere
制动器	brake
制度化	systematization
刺客	assassin
刺激物	stimulus
刺绣品	embroidery
刺耳	ear-piercing
刺猬	hedgehog
刻板印象	stereotype
刻痕	notch
前备箱	frunk
前传	prequel
前凸后翘	buxom
前列腺	prostate
前列腺炎	prostatitis
前列腺素	prostaglandin
前哨战	skirmish
前因	antecedents
前女友	ex-girlfriend
前寒武纪	pre-Cambrian
前戏	foreplay
前所未闻	unprecedented
前提条件	preconditions
前桅	foremast
前段时间	recently
前男友	ex-boyfriend
前腿	forelegs
前臂	forearm
前菜	appetizer
剖腹自杀	hara-kiri
刚度	stiffness
刚性	rigidity
刚毛	bristle
剪草机	lawnmower
剪贴簿	scrapbook
副主席	vice-chairperson
副刊	supplement
副校长	vice-principal
副业	sideline
副标题	subheading
副产品	by-product
副秘书长	vice-secretary
副总统	vice-president
副词	adverb
副议长	vice-chairman
副驾驶员	copilot
副黏液病毒	paramyxovirus
创作者	creator
创口	wound
创可贴	band-aid
创建者	founder
创业者	entrepreneur
剸	slash
划时代	epoch-marking
剧作家	playwright
剧本	script
剧集	series
劈离	split
剑客	swordsman
剑桥	Cambridge
剑术	swordsmanship
剑鱼	swordfish
剑龙	stegosaurus
劘	whittle
力波	Reeb
力矩	torque
力量	power
功利	utility
功利主义	utilitarianism
功效	efficacy
功烈	achievement
功能性	functionality
加之	moreover
加利福尼亚	California
加利福尼亚大学洛杉矶分校	UCLA
加利西亚	Galicia
加勒比	Caribbean
加密货币	cryptocurrency
加宽	widen
加德满都	Kathmandu
加拉加斯	Caracas
加拉巴哥斯	Galapagos
加拿大	Canada
加数	addend
加法	addition
加泰罗尼亚	Catalonia
加湿器	humidifier
加甜	sweeten
加的夫	Cardiff
加的斯	Cádiz
加纳	Ghana
加蓬	Gabon
加速度	acceleration
加里肋亚	Galilee
劣等	poor-quality
劣质	shoddy
助理	assistant
助词	particle
努克	Nuuk
努比亚	Nubia
努美阿	Nouméa
劫难	calamity
劬	labor
劻	zealous
勃朗宁	Browning
勃兰登堡	Brandenburg
勇敢	brave
勇气	courage
勒索罪	blackmail
动名词	gerund
动机	motive
动物性	animacy
动物毒素	zootoxin
动脉	artery
动脉瘤	aneurysm
动脉粥样硬化	atherosclerosis
动觉	kinesthesia
动词	verb
动量	momentum
动魄	shocking
勘误表	corrigenda
勋章	medal
胜任能力	competency
胜者	winner
劳务人员	laborer
劳拉西泮	lorazepam
劳斯莱斯	Rolls-Royce
势利	snobbish
势利小人	snob
勤快	diligent
勋绩	exploit
勷	haste
勿忘我	forget-me-not
包价	package
包皮环切术	circumcision
包菜	cabbage
包装物	packaging
匆匆	hurriedly
匆猝	hurried
匈奴	Xiongnu
匈牙利	Hungary
匕首	dagger
化妆舞会	masquerade
化学信息素	semiochemical
化学品	chemicals
化学家	chemist
化学性	chemical
化学疗法	chemotherapy
化学需氧量	COD
化油器	carburetor
化石	fossil
北佬	northerner
北圻	Tonkin
北方工业	Norinco
北海道	Hokkaidō
北莱茵·威斯特法伦州	Nordrhein-Westfalen
匙	spoon
匠	craftsman
匣	box
匪徒集团	gangster
汇划	remittance
汇寄	remit
匹夫匹妇	commoners
匿名	anonymous
区域性	regional
十一月份	November
十二指肠	duodenum
十二月份	December
十二边形	dodecagon
十二面体	dodecahedron
十亿位元	gigabit
十克	decagram
十六进制	hexadecimal
十四	fourteen
十四行诗	sonnet
十字架刑	crucifiction
十字丝	crosshairs
十字绣	cross-stitch
十月份	October
十进制	decimal
十边形	decagon
十项全能	decathlon
千	thousand
千伏	kilovolt
千位元	kilobit
千克	kilogram
千吨	kiloton
千字节	kilobyte
千层面	lasagna
千年	millennium
千焦	kilojoule
千瓦时	kilowatt-hour
千米	kilometer
千赫	kilohertz
千足虫	millipede
千里眼	clairvoyance
卅	thirty
午夜	midnight
午后	afternoon
午餐会	luncheon
卉	plants
半乳糖血症	galactosemia
半信半疑	skeptical
半圆	semicircle
半圆仪	protractor
半圆形	semicircular
半大不小	teenage
半官方	semiofficial
半封建	semifeudal
半导体	semiconductor
半岛	peninsula
半径	radius
半文盲	semiliterate
半殖民地	semicolonial
半决赛	semifinals
半流体	semifluid
半无限	semi-infinite
半熟	half-cooked
半熟练	semiskilled
半球	hemisphere
半神	demigod
半空	midair
半腱肌	semitendinosus
半自动	semiautomatic
半裸	half-naked
半规则	quasi-regular
半开化	semicivilized
半开半关	half-open
半音程	semitone
卌	forty
卍	swastika
卑南族	puyuma
卑尔根	Bergen
卑鄙无耻	despicable
协奏曲	concerto
协处理器	coprocessor
协调员	coordinator
南	south
南安普敦	Southampton
南岛民族	Austronesian
南希	Nancy
南方古猿	Australopithecus
南极洲	Antarctica
南瓜	pumpkin
南瓜灯	jack-o'-lantern
南诏国	Nanzhao
南赡部洲	Jambudvipa
博主	blogger
博伊西	Boise
博士学位	PhD
博士后	postdoc
博学	learned
博客圈	blogosphere
博彩	gambling
博格多	Bogdo
博尔德	Boulder
博物馆	museum
博福斯	Bofors
博茨瓦纳	Botswana
博蒙特	Beaumont
博鳌镇	Bo'ao
占婆	Champa
占星师	astrologer
占星术	astrology
占比	proportion
卡丁车	go-kart
卡利亚里	Cagliari
卡利卡特	Calicut
卡利多尼亚	Caledonia
卡塔尼亚	Catania
卡塔尔	Qatar
卡塔赫纳	Cartagena
卡夫	Kraft
卡宴	Cayenne
卡尺	calipers
卡恩	Kahn
卡扣	clip
卡拉布里亚	Calabria
卡斯特利翁	Castellón
卡斯蒂利亚·莱昂	Castilla-Leon
卡尔加里	Calgary
卡尔顿	Carleton
卡片	card
卡美洛	Camelot
卡西欧	Casio
卡顿	unresponsive
印古什	Ingushetia
印堂穴	yintang
印度	India
印度尼西亚	Indonesia
印度斯坦	Hindustan
印度音乐	Bhangra
印度－雅利安	Indo-Aryan
印第安纳	Indiana
印第安纳波利斯	Indianapolis
危地马拉	Guatemala
危害性	harmfulness
即插即用	plug-and-play
即时	immediate
即时即地	moment-to-moment
即由	namely
即兴发挥	improvisation
卵子	ovum
卵巢	ovary
卵母细胞	ovocyte
卵石	cobble
卷帙	book
卷须	tendril
厄娃	Eve
厄瓜多尔	Ecuador
厄立特里亚	Eritrea
厚度	thickness
厚颜无耻	shameless
原函数	antiderivative
原则性	principled
原创性	originality
原子弹	A-bomb
原居	indigenous
原木	logs
原核生物	prokaryote
原生质	protoplasm
原声带	soundtrack
原虫	protozoan
厌女症	misogyny
厌烦	bored
厌食症	anorexia
厉行	rigorously
去中心化	decentralization
去向	whereabouts
参孙	Samson
参数	parameter
参与者	participant
参议员	senator
参鸡汤	samgyetang
叉勺	spork
叉形	forked
友善	friendly
反例	counterexample
反倾销	anti-dumping
反共	anti-communist
反动派	reactionaries
反叛分子	rebel
反坦克	anti-tank
反季节	off-season
反安慰剂	nocebo
反射镜	reflector
反差	contrast
反应堆	reactor
反战	anti-war
反批评	countercriticism
反散射	backscatter
反日	anti-Japan
反时势	unconventional
反时针	counterclockwise
反智	anti-intellectual
反智主义	anti-intellectualism
反气旋	anticyclone
反乌托邦	dystopia
反照	reflection
反物质	antimatter
反犹太主义	antisemitism
反用换流器	inverter
反美	anti-American
反义词	antonym
反而	instead
反腐	anti-corruption
反舰艇	anti-ship
反刍动物	ruminant
反英	anti-English
反英雄	antihero
反华	anti-Chinese
反诉状	counterclaim
反语	irony
反贪污	anticorruption
反转录病毒	retrovirus
反革命	counterrevolutionary
反高潮	anticlimax
反党	anti-party
取款机	ATM
受害人	victim
受欢迎	popular
受穷	poor
受托者	trustee
受访者	interviewee
受难纪念	memorial
叛国	treason
叛教	apostasy
口哨	whistle
口感	mouthfeel
口才	eloquence
口水	saliva
口渴	thirsty
口琴	harmonica
口粮	ration
口红	lipstick
口角	altercation
口译	interpreting
口足目	Stomatopoda
口风琴	melodica
古人类学	paleoanthropology
古典	classical
古典派	classicists
古地磁	paleomagnetism
古巴	Cuba
古文字学	paleography
古时	antiquity
古气候学	paleoclimatology
古物	antique
古生物	paleo-organism
古生物学	palaeontology
古生物学家	paleontologist
古旧	archaic
句法	syntax
另用	diversion
叨	garrulous
只	only
只要	provided
叫法	term
召集人	convener
叮当声	tinkle
叮铃	jingle
可不是	indeed
可信	trustworthy
可信任	trusty
可动	movable
可口可乐	Coca-Cola
可哀	miserably
可嘉	laudable
可回收	recyclable
可塑性	plasticity
可压缩	compressible
可容忍	tolerable
可尊敬	respectable
可得到	available
可恨	hateful
可悲	lamentable
可恼	aggravating
可想像	conceivable
可虑	worrisome
可憎	disgusting
可懂度	intelligibility
可持续	sustainable
可接受性	acceptability
可擦写	erasable
可支付性	affordability
可敬	venerable
可望而不可及	unattainable
可乐饼	croquette
可比	comparable
可溶	soluble
可溶性	solubility
可燃	inflammable
可疑分子	suspect
可知论	gnosticism
可编程	programmable
可能性	possibility
可行性	feasibility
可裂变	fissionable
可视化	visualization
可视电话	videophone
可调	adjustable
可读性	readability
可变	variable
可逆性	reversibility
可靠	reliable
可靠性	reliability
可食	edible
台北	Taipei
台南	Tainan
台座	pedestal
台式	Taiwanese-style
台球	billiards
史册	annals
史学	historiography
史蒂文	Steven
史诗级	epic
右撇子	right-hander
右派分子	rightist
司兼导	driver-guide
司机	chauffeur
司法权	jurisdiction
司汤达	Stendhal
叻沙	laksa
吃播	mukbang
各人	everyone
各种	various
合情合理	fair
合宪性	constitutionality
合法性	legitimacy
合理	rational
合众银行	Bancorp
合股线	twine
合规	compliance
合适	suitable
合金	alloy
吉事果	churro
吉利	Geely
吉布提	Djibouti
吉尔吉斯斯坦	Kyrgyzstan
吉祥物	mascot
吉米	Jimmy
吊儿郎当	sloppy
吊床	hammock
吊绳	sling
同上	ditto
同事	colleague
同仁堂	Tongrentang
同伴	companion
同位	par
同位素	isotope
同型性	isomorphism
同型配子	isogamete
同性爱	homosexual
同时	simultaneously
同时代	contemporary
同步加速器	synchrotron
同源词	cognate
同班同学	classmate
同理	Tongli
同理心	empathy
同盟	alliance
同素异形体	allotropy
同义	synonymous
同义反复	tautology
同义词	synonym
同胞兄妹	sibling
同质	homogeneous
同轴	coaxial
同配生殖	isogamy
同音词	homophone
同类相食	cannibalism
名古屋	Nagoya
名媛	debutante
名宿	luminary
名义上	nominally
名录	directory
后羿	Houyi
吐根	ipecac
向何处	whither
向南	southward
向外	outward
向后	backward
向性	tropism
向东	eastwards
向西	westward
向西南	southwestward
君主制	monarchy
君士坦丁堡	Constantinople
吝啬	stingy
吝啬鬼	miser
吞吐量	throughput
否则	otherwise
否决票	veto
吧女	barmaid
含情脉脉	tender-hearted
含意	meaning
含水	watery
含水层	aquifer
含片	lozenge
含碳	carbonic
吰	clang
吱吱声	squeak
吴哥城	Ankorwat
吵杂	noisy
吸入剂	inhalant
吸入器	inhaler
吸气器	aspirator
吸睛	eye-catching
吸积	accretion
吸音	sound-absorbing
吹哨人	whistleblower
吹笛者	piper
吹管	blowpipe
吻部	snout
吼声	roar
吾	my
呀诺达	Yanoda
吕	pitchpipe
吕贝克	Lübeck
呆笨	dimwitted
呆头呆脑	oafish
告示	announcement
告解	confession
呢喃细语	murmuring
呧	vex
周围	environs
周径	girth
周庄	Zhouzhuang
周边商品	merch
味之素	Ajinomoto
味儿	taste
味醂	mirin
呷呷	honk
呼叫声	whoop
呼吸管	snorkel
呼呼声	whir
命名法	nomenclature
命相	horoscope
咈	oppose
和善	good-natured
和平主义	pacifism
和服	kimono
和洽	harmonious
和牛	wagyu
和田市	Hotan
咖啡师	barista
咚咚	Dongdong
咯吱	groan
咯咯笑	chuckle
咳	cough
咷	wail
咹	eh?
咽喉	throat
咽炎	pharyngitis
咽头	pharynx
哀失	bereavement
哀艳	poignant
品目	item
品红	magenta
品级	workmanship
品达	Pindar
哆啦A梦	Doraemon
哈佛	Harvard
哈利	Harry
哈博罗内	Gaborone
哈啰出行	Hellobike
哈奴曼	Hanuman
哈巴罗夫斯克	Khabarovsk
哈恩	Jaén
哈拉雷	Harare
哈日	Japanophile
哈普西科德	harpsichord
哈根达斯	Häagen-Dazs
哈梅内伊	Khamenei
哈欠	yawn
哈特福德	Hartford
哈瓦那	Havana
哈罗德	Harold
哈萨克斯坦	Kazakhstan
哈迪斯	Hades
哈里斯堡	Harrisburg
哈里发国	caliphate
哈灵根	Harlingen
哈马黑拉岛	Halmahera
哐	bang
哐啷	clatter
员工	staff
员警	policeman
哤	jargon
哥斯拉	Godzilla
哥特式	gothic
哨兵	sentinel
哩	mile
哪一个	which
哪吒	Nezha
哮喘	asthma
哮鸣	wheezing
哲学	philosophy
哲学家	philosopher
哺乳动物	mammal
哺乳纲	Mammalia
哺乳类动物	mammals
哼唧	whisper
哼声	hum
唇	lip
唇形科	Labiatae
唐狗	mongrel
唯	yes
唯一性	uniqueness
唯物	materialistic
唯物主义	materialism
唯象	phenomenological
唱名	solfege
唱机	gramophone
唱碟	LP
唱词	libretto
唱诗班	choir
唾沫星子	sputter
唿喇	whoosh
啄木鸟	woodpecker
啅	chirp
商品化	commodification
商汤科技	SenseTime
商队	caravan
启动子	promoter
启发式	heuristic
启示者	revelator
啤	beer
啤酒厂	brewery
啦啦队长	cheerleader
喀土穆	Khartoum
喀山	Kazan
喀布尔	Kabul
喀尔喀	Khalkha
善感	sensitive
喇叭形	flared
喇叭水仙	daffodil
喇嘛	lama
喉炎	laryngitis
喉镜	laryngoscope
喊话器	megaphone
喜人	pleasing
喜乐	joy
喜气洋洋	jubilation
喜兴	joyous
喜马拉雅山	Himalayas
喦	talkative
丧尸	zombie
丧心病狂	demented
丧气	unlucky
丧钟	knell
乔治敦	Georgetown
单元房	apartment
单丛	Dancong
单向	unidirectional
单峰驼	dromedary
单方面	unilateral
单晶	monocrystalline
单核细胞增多症	mononucleosis
单糖	monosaccharide
单细胞	unicellular
单翼飞机	monoplane
单脚滑行车	scooter
单语	monolingual
单调	monotonous
单身汉	bachelor
单车族	cyclist
单轨	monorail
单轮车	unicycle
单边主义	unilateralism
单铬	monochrome
单项	single-item
嗓音	voice
嗜好	hobby
嗜杀成性	bloodthirsty
嗞啦	sizzle
嗯哼	uh-huh
嘁嘁喳喳	chattering
嘉士伯	Carlsberg
嘉义	Chiayi
呕	vomit
呕出物	vomitus
叽	grumble
嘴巴子	slap
嘴牢	tight-lipped
嘴笨	inarticulate
嘴松	loose-tongued
嘿	hey
器具	implement
器官	apparatus
噩	startling
噩梦	nightmare
噪声	noise
噬菌体	bacteriophage
噭	shout
喷嚏	sneeze
喷嚏剂	sternutator
喷气式	jet-propelled
喷泉	fountain
喷火器	flamethrower
喷灯	blowtorch
喷雾器	sprayer
噶玛兰族	Kavalan
吨数	tonnage
当啷	clanging
哜	sip
啮齿动物	rodent
严密	tight
严重性	seriousness
嚼劲	chewiness
嚼蜡	insipid
冁	smilingly
囊泡	vesicle
囊空如洗	broke
啮齿类	rodents
囔	muttering
囗	enclosure
囚犯	prisoner
四分之一	one-quarter
四月份	April
四氢大麻酚	Tetrahydrocannabinol
四氯乙烯	tetrachloroethylene
四环素	tetracycline
四角形	quadrilateral
四轮马车	chariot
四部曲	tetralogy
四面体	tetrahedron
回执单	receipt
回忆录	memoir
回文	palindrome
回旋曲	rondo
回冲	backwash
回声	echo
回声定位	echolocation
因式分解	factorization
因斯布鲁克	Innsbruck
因此	thus
因纽特	Inuit
囮	decoy
困窘	embarrassment
固体	solid
固体食物	solids
圈	pen
圈内人	insider
圈套	trap
圈状物	hoop
国内生产毛额	GDP
国君	monarch
国子监	Guozijian
国度	country
国会大厦	capitol
国有化	nationalization
国民生产毛额	GNP
国王	king
国籍	nationality
国美	GOME
国际	international
国际主义	internationalism
国际文传电讯社	Interfax
围兜	bib
围产	perinatal
围裙	apron
园丁	gardener
园囿	park
园林	gardens
圆周	circumference
圆圈	circle
圆形剧场	amphitheater
圆形木材	log
圆括号	parentheses
圆明园	Yuanmingyuan
圆柱形	cylindrical
圆滚滚	plump
圆满	satisfactory
圆珠	bead
圆盘	disk
圆舞曲	waltz
圆角	fillet
圆锥体	cone
圆顶	dome
圆点	dot
图像	image
图坦卡蒙	Tutankhamen
图恩	Thun
图书管理员	librarian
图案	design
图波列夫	Tupolev
图片报	Bild-Zeitung
图瓦	Tuva
图西族	Tutsi
图钉	thumbtack
图录	catalog
团队	team
𪢮	round
土匪	bandit
土器	earthenware
土堆	mound
土壤	soil
土库曼斯坦	Turkmenistan
土得掉渣	uncouth
土方工程	earthwork
土耳其	Turkey
土著	aboriginal
土豆网	Tudou
在下面	underneath
在地下	underground
在后	behind
在户外	outdoors
在深处	deeply
圩	dike
圭亚那	Guyana
地下水	groundwater
地下通道	underpass
地下铁路	subway
地图册	atlas
地塞米松	dexamethasone
地心吸力	gravitation
地拉那	Tirana
地标	landmark
地壳运动	diastrophism
地滑	landslide
地球化学	geochemistry
地球物理学	geophysics
地理学	geography
地理学家	geographer
地理定位	geolocation
地窨	cellar
地籍	cadaster
地缘战略	geostrategic
地缘政治学	geopolitics
地衣	lichen
地貌	geomorphology
地质学	geology
地质学家	geologist
地震	earthquake
地震仪	seismometer
均等	equal
均变论	uniformitarianism
坎儿井	karez
坎帕拉	Kampala
坎昆	Cancún
坎特伯雷	Canterbury
坐骨	ischium
坐骨神经痛	sciatica
坑坑洼洼	bumpy
坡道	ramp
坦桑尼亚	Tanzania
坦率	frank
坩埚	crucible
垂死	dying
垂直	perpendicular
垂钓	angling
垃圾筒	trashcan
型板	template
垛口	crenel
垝	collapsed
埃及	Egypt
埃及古物学	Egyptology
埃及古物学者	Egyptologist
埃及豆	chickpea
埃塞俄比亚	Ethiopia
埃奥罗斯	Aeolus
埃德蒙顿	Edmonton
埃拉特	Eilat
埃叙	Egypt-Syria
埃文河畔斯特拉特福	Stratford-upon-Avon
埃涅阿斯	Aeneas
埃米尔	amir
城址	townsite
城市化	urbanization
城里人	townspeople
域名抢注	cybersquatting
执照	license
埸	border
基因型	genotype
基因学	genetics
基因改造	GM
基因组	genome
基地	al-Qaeda
基地组织	Al-Qaeda
基多	Quito
基岩	bedrock
基布兹	kibbutz
基底	plinth
基拉韦厄	Kilauea
基材	substrate
基督徒	Christian
基础结构	infrastructure
基金	fund
坚不可摧	indestructible
坚固性	firmness
坚强不屈	steadfast
坚忍不拔	fortitude
坚果	nut
坚若磐石	rock-solid
坚贞不渝	unwavering
堆肥	compost
堆高机	forklift
堞	battlements
堡垒	fort
堧	adjoin
堪萨斯	Kansas
堪舆	geomancy
堰	weir
报告文学	reportage
报复心	vindictiveness
报复性	retaliatory
报应	karma
报摊	newsstand
报料人	informant
报章	newspapers
报童	paperboy
堲	hate
场景	scene
块状	lump
塑化剂	plasticizer
塔什干	Tashkent
塔吉克斯坦	Tajikistan
塔夫绸	taffeta
塔帕斯	tapas
塔拉哈西	Tallahassee
塔拉瓦	Tarawa
塔木德经	Talmud
塔林	Tallinn
涂料	paint
涂油于	anoint
塞内加尔	Senegal
塞浦路斯	Cyprus
塞尔特	Celtic
塞瓦斯托波尔	Sevastopol
塞纳河	Seine
塞维利亚	Seville
填充物	filler
填地	landfill
填塞物	stuffing
填字游戏	crossword
尘肺	pneumoconiosis
堑	chasm
堑壕	trench
境地	circumstances
境遇	circumstance
垫子	cushion
垫被	mattress
墓园	cemetery
墓场	graveyard
墓石	tombstone
墓窖	catacomb
墓志铭	epitaph
增强现实	AR
增稠剂	thickener
增量	increment
墨水瓶架	inkstand
墨尔本	Melbourne
墨西哥	Mexico
墨西哥人	Mexican
墨西哥辣椒	jalapeño
墨西拿	Messina
墨鱼	cuttlefish
墺	building-plot
壁架	ledge
壁炉	fireplace
壁纸	wallpaper
壁虎	gecko
压力	pressure
压根	absolutely
压缩	compression
压缩器	compressor
压电体	piezo-electric
垒固	Loi-kaw
垒球	softball
坏死	necrosis
坏血病	scurvy
士气	morale
壮美	magnificent
壶铃	kettlebell
寿司	sushi
寿喜烧	sukiyaki
夏	summer
夏利	Xiali
夏商周	Xia
夏士莲	Hazeline
夏威夷	Hawaii
夏延	Cheyenne
夏日	summertime
夏洛特敦	Charlottetown
夏尔巴人	Sherpa
外交官	diplomat
外来词	loanword
外分泌	exocrine
外包	outsourcing
外国人	foreigner
外围	surrounding
外星人	extraterrestrial
外源	exogenous
外用	external
外科手术	surgery
外袍	robe
外设	peripherals
外貌主义	lookism
外邦人	gentile
外阴	vulva
外头	outside
外显	visible
多佛	Dover
多伦多	Toronto
多侧面	many-sided
多元性	diversity
多元文化主义	multiculturalism
多元论	pluralism
多哥	Togo
多国	multinational
多媒体	multimedia
多孔	porous
多字节	multibyte
多寡	number
多山	mountainous
多工作业	multitasking
多工器	multiplexer
多工运作	multithreading
多巴胺	dopamine
多态	polymorphism
多才多艺	multitalented
多数	majority
多星	starry
多晶	polycrystalline
多模	multimode
多样性	variegation
多民族	multiethnic
多水分	juicy
多瑙河	Danube
多用户	multiuser
多用途	multipurpose
多疑	mistrustful
多神论	polytheism
多神论者	polytheist
多种	multiple
多种维生素	multivitamin
多站	multistation
多米诺骨牌	dominoes
多糖	polysaccharide
多细胞	multicellular
多义性	equivocality
多肉	fleshy
多肽	polypeptide
多胞形	polytope
多叶	leafy
多语言	multilingual
多边	multilateral
多边形	polygon
多邻国	Duolingo
多重性	multiplicity
多面手	all-rounder
多面体	polyhedron
多音	polyphony
多项式	multinomial
多党	multiparty
夜	night
夜幕降临	nightfall
夜店	nightclub
夜景	nightscape
夜行性	nocturnality
夜莺	nightingale
梦境	dreamland
梦景	dreamscape
梦核	dreamcore
大使级	ambassadorial
大便干燥	constipated
大修	overhaul
大元帅	generalissimo
大力	energetically
大卡	kilocalorie
大吃一惊	flabbergasted
大吉岭	Darjeeling
大喜	exultation
大嘴鸟	toucan
大地水准面	geoid
大地洞	cavern
大地测量学	geodesy
大城市	metropolis
大堂	lobby
大墓地	necropolis
大坝	dam
大大咧咧	offhand
大寨	Dazhai
大屠杀	massacre
大山	Dashan
大幅度	substantially
大厅	hall
大恭	feces
大拇指	thumb
大括号	braces
大提琴手	cellist
大数	Tarsus
大日如来	Vairocana
大昭寺	Jokhang
大会报告起草人	rapporteur
大比目鱼	halibut
大气圈	atmosphere
大洋洲	Oceania
大洋龙	halisaurus
大洲	continent
大浦洞	Taepodong
大漠	desert
大灯	headlight
大猩猩	gorilla
大疆	DJI
大发	Daihatsu
大盘子	platter
大众汽车	Volkswagen
大范围	large-scale
大能	almighty
大脚怪	bigfoot
大腿	thigh
大致	roughly
大兴区	Daxing
大茴香子	aniseed
大菱鲆	turbot
大虫	tiger
大豆	soybean
大辟	decapitation
大农场	ranch
大部	most
大都	Dadu
大釜	cauldron
大锤	sledgehammer
大错	blunder
大镰刀	scythe
大阪	Osaka
大陆性	continental
大马士革	Damascus
大鹿	moose
大麦	barley
天主教	Catholicism
天使	angel
天刚亮	daybreak
天问一号	Tianwen-1
天坑	sinkhole
天寒地冻	frigid
天敌	predator
天文学	astronomy
天文学家	astronomer
天文馆	planetarium
天枢	Dubhe
天权	Megrez
天气	weather
天璇	Merak
天玑	Phecda
天空	sky
天竺牡丹	dahlia
天线宝宝	Teletubbies
天台	rooftop
天课	zakat
天门冬科	Asparagaceae
天顶	zenith
天体演化学	cosmogony
天体物理	astrophysics
天体物理学家	astrophysicist
天鹅	swan
太古	immemorial
太妃糖	taffy
太婆	great-grandmother
太子港	Port-au-Prince
太子党	princelings
太空行走	spacewalk
太长不看	DR
太阳灯	sunlamp
太阳镜	sunglasses
太阳雨	sunshower
太阳黑子	sunspot
太鲁阁族	Taroko
夫余	Pu'yo
夬	decisive
失修	disrepair
失坠	loss
失败主义	defeatism
失败者	loser
失温症	hypothermia
失物招领	lost-and-found
失读症	alexia
失身分	demeaning
失重	weightlessness
夹钳	tongs
夹头	chuck
奇事	marvel
奇卡诺人	Chicano
奇才	genius
奇瓦瓦	Chihuahua
奇观	spectacle
奇迹	miracle
奈良	Nara
奉承者	flatterer
奉献精神	dedication
奎星	Kuixing
奏鸣曲	sonata
契卡	Cheka
契据	deed
奔驰	Mercedes-Benz
套利	arbitrage
套利者	arbitrager
套钟	chime
套鞋	overshoes
奠基石	cornerstone
奢靡	extravagant
奥地利	Austria
奥德修斯	Odysseus
奥托	Otto
奥斯瓦尔德	Oswald
奥斯陆	Oslo
奥林匹克	Olympic
奥林巴斯	Olympus
奥氏体	austenitic
奥波莱	Opole
奥尔巴尼	Albany
奥尔良	Orléans
奥特曼	Ultraman
奥胡斯	Aarhus
奥腊涅斯塔德	Oranjestad
奥兰多	Orlando
奥迪	Audi
奥里里亚	Aurelia
奥马哈	Omaha
奥黛丽	Audrey
奋起湖	Fenchihu
女人	woman
女修道院	convent
女仆	maid
女傧相	bridesmaid
女儿	daughter
女巫	witch
女房东	landlady
女朋友	girlfriend
女权主义	feminism
女武神	valkyrie
女王	queen
女管家	housekeeper
女继承人	inheritress
女舍监	matron
女警	policewoman
女高音	soprano
奴性	servility
奴隶	slave
奴隶制	slavery
奶汁烤	gratin
奶油果	avocado
奶站	dairy
奶酪火锅	fondue
奸商	profiteer
她	she
好事之徒	busybody
好吃	tasty
好好	well
好战	warlike
好氧	aerobic
好笑	laughable
如今	nowadays
如来佛	Tathagata
如此	so
如火	fiery
如画	picturesque
如痴如醉	mesmerized
如花	flowery
如草	grassy
妄自尊大	arrogance
妓女	prostitute
妖媚	seductive
妖孽	evildoer
妖物	monster
妖术	sorcery
妖魔	demon
妙笔	talented
妙语	witticism
妯娌	sisters-in-law
妻子	wife
姅	menstruation
姆巴巴内	Mbabane
始祖鸟	Archaeopteryx
姗姗	leisurely
姑父	uncle
委内瑞拉	Venezuela
委员会	committee
奸情	adultery
侄女	niece
侄子	nephew
侄孙	grandnephew
姻亲	in-laws
威廉斯堡	Williamsburg
威望	prestige
威尔士	Wales
娓娓	engagingly
娘胎	womb
婆罗门	Brahmin
婉词	euphemism
婚外	extramarital
婚嫁	marriage
婚神星	Juno
婞	upright
妇科	gynecology
婼	recalcitrant
媒妁	go-between
媒婆	matchmaker
媒体	media
媚词	flattery
媢	envious
妈妈桑	madam
妈祖	Matsu
嫁妆	dowry
嫂子	sister-in-law
嫌恨	hatred
嫚	insult
嫩主	newbie
娴淑	ladylike
娇美	dainty
婴儿期	infancy
婴孩	infant
婴幼儿	baby
婴猴	galago
娈童恋	pederasty
子午线	meridian
子品牌	sub-brand
子囊菌	ascomycete
子女	children
子宫托	pessary
子层	sublayer
子模型	submodel
子爵	viscount
子癫前症	pre-eclampsia
子程序	subroutine
子粒	seed
子系统	subsystem
子网	subnetwork
子集	subset
孑孓	wiggler
孔丘	Confucius
孔方兄	coll.
孔雀	peafowl
孕	pregnant
孕期	pregnancy
孕激素	progesterone
字图	glyph
字幕	subtitles
字汇	Zihui
字林	Zilin
字母表	alphabet
字眼	wording
字节跳动	ByteDance
字素	grapheme
字首	prefix
存在主义	existentialism
存根	stub
存量	reserves
孜孜矻矻	diligently
孜然芹	cumin
孟加拉国	Bangladesh
孢子	spore
季候	season
季节性	seasonal
季风	monsoon
季黎诺	Quirinius
孤儿	orphan
孤绝	isolated
孱	feeble
学位论文	dissertation
学前班	preschool
学友	schoolmate
学究	pedant
学童	schoolchild
学者	scholar
𡥧	last
它	it
它本身	itself
宅子	house
宇宙	universe
宇宙学	cosmology
宇宙号	Kosmos
宇宙飞船	spaceship
宇航员	astronaut
宇航服	spacesuit
守时	punctual
守望台	watchtower
守军	defenders
守门人	gatekeeper
守门员	goalkeeper
安保	security
安卡拉	Ankara
安吉星	OnStar
安哥拉	Angola
安圭拉	Anguilla
安定化	stabilization
安宁片	meprobamate
安息国	Parthia
安息日	Sabbath
安息香科	Styracaceae
安慰剂	placebo
安提瓜岛	Antigua
安曼	Amman
安格斯	Angus
安乐死	euthanasia
安稳	steady
安联	Allianz
安详	serene
安道尔	Andorra
安养院	hospice
完备性	completeness
完完全全	completely
完美	perfect
完美主义者	perfectionist
宏碁	Acer
宏观经济	macroeconomic
宏观经济学	macroeconomics
宏观调控	macro-control
宗主权	suzerainty
宗教	religion
宗派	sect
宗派主义	sectarianism
官僚主义	bureaucracy
官办	government-run
宙斯	Zeus
定型水	hairspray
定居者	settler
定居点	settlement
定州市	Dingzhou
定标器	scaler
定殖	colonization
定洋	deposit
定理	theorem
定当	necessarily
定音鼓	timpani
宜人	nice
宜家	IKEA
宜居	livable
客户	client
客观性	objectivity
宣武门	Xuanwumen
宣礼塔	minaret
宣誓供词证明	deposition
室内	indoor
室友	roommate
宫阙	palace
宫颈	cervix
宴席	banquet
家庭主夫	househusband
家庭主妇	housewife
家庭作业	homework
家政	housekeeping
家乐福	Carrefour
家里	home
宿	constellation
宿醉	hangover
宿雾	Cebu
寁	swift
寂静	quiet
寄件人	sender
寄宿生	boarder
寄生物	parasite
密克罗尼西亚	Micronesia
密宗	tantra
密文	ciphertext
密歇根	Michigan
密特朗	Mitterrand
密码学	cryptography
密致	compact
密苏里	Missouri
密西西比	Mississippi
密集恐惧症	trypophobia
密云区	Miyun
富士通	Fujitsu
富于想像	imaginative
富纳富提	Funafuti
富良野	Furano
富色彩	colorful
富裕	prosperous
寒战	shiver
寓所	dwelling
寡妇	widow
寡糖	oligosaccharide
寡头	oligarch
寡头垄断	oligopoly
寡头政治	oligarchy
寤寐	constantly
实力	strength
实力主义	meritocracy
实地	on-site
实打实	no-nonsense
实施例	embodiment
实业家	industrialist
实用主义	pragmatism
实际参数	argument
实际性	practicality
审慎	prudent
审计长	auditor
宽宏	magnanimous
宽宏大量	generous
宽屏	widescreen
宽带	broadband
宽度	width
宝可梦	Pokémon
宝塔	pagoda
宝宝	darling
宝丽来	Polaroid
封建主义	feudalism
封条	seal
封斋节	Lent
射击学	ballistics
射线	ray
射门	soccer
将官	general
将军肚	potbelly
专事	specialized
专家	expert
专属	proprietary
专案	project
专业化	specialization
专科院校	academy
专门家	specialist
寻回犬	retriever
寻常	usual
寻水术	dowsing
对句	couplet
对抗性	antagonistic
对数	logarithm
对于	regarding
对案	counterproposal
对氨基苯丙酮	p-aminopropiophenone
对流	convection
对称性	symmetry
对讲电话	intercom
对证	confrontation
对跖点	antipode
导论	introduction
导轨	slideway
小丑	clown
小便池	urinal
小偷	thief
小儿经	Xiao'erjing
小儿麻痹病毒	poliovirus
小包	packet
小吃	snack
小型核武器	mini-nuke
小型柜橱	cabinet
小夜曲	serenade
小孩堤防	Kinderdijk
小孩子	child
小写	lowercase
小岩洞	grotto
小岛	isle
小巴	minibus
小巷	alley
小年轻	youngster
小扁豆	lentil
小打小闹	small-scale
小提琴手	violinist
小支气管	bronchiole
小斑点	speckle
小松菜	komatsuna
小树林	grove
小步舞曲	minuet
小毛虫	slug
小河	creek
小泡	vesicles
小清新	hipster
小瀑布	cascade
小牛肉	veal
小牝牛	heifer
小狗	pup
小百科全书	micropedia
小碟子	saucer
小米	Xiaomi
小米辣	xiaomila
小精灵	elf
小组委员会	subcommittee
小考	quiz
小舌	uvula
小船	boat
小袋	pouch
小计	subtotal
小说家	novelist
小谎	fib
小猫	kitten
小起重机	jack
小路	lane
小辫	pigtail
小酒馆	bistro
小鸡	chick
小额融资	microfinance
小松糕	muffin
小鹅	gosling
小黄瓜	gherkin
少女峰	Jungfrau
尖牙	fang
尖声啼哭	squeal
尤其	especially
尤文图斯	Juventus
尰	swell
就职典礼	inauguration
尴尬	awkward
尻	rump
尼亚美	Niamey
尼加拉瓜	Nicaragua
尼哥底母	Nicodemus
尼布甲尼撒	Nebuchadnezzar
尼散月	Nisan
尼日利亚	Nigeria
尼桑	Nissan
尼泊尔	Nepal
尼雅	Niya
尾气	exhaust
尾注	endnote
尾韵	rhyme
尿布	diaper
尿液	urine
局外中立	neutralism
屁话	bullshit
居住者	inhabitant
居所	residence
居民	resident
屈伦博赫	Culemborg
屈光度	diopter
屈膝礼	curtsy
屋顶	roof
尸检	autopsy
尸体	corpse
屏幕保护程序	screensaver
屏障	barrier
屐	clogs
屠户	butcher
屡加	ply
屡劝不听	incorrigible
层压	lamination
层子	stratum
层次分明	layered
层理	stratification
屦	sandals
属吏	underling
山丘	hill
山坡	hillside
山坞	nook
山崖	cliff
山巅	summit
山水	Sansui
山沟沟	backwoods
山墙	gable
山竹	mangosteen
山羊绒	cashmere
山羊胡子	goatee
山茶	camellia
山葵	wasabi
山贼	brigand
山达基	Scientology
山雀	tit
山青水灵	scenic
山顶	hilltop
山麓	foothills
冈比亚	Gambia
岩仓	Iwakura
岩沙海葵毒素	palytoxin
岩石	rock
岩羊	bharal
岸边	shore
岛屿	island
岛民	islander
峡	gorge
峡湾	fjord
崇拜者	worshipper
崇祯	Chongzhen
昆士兰	Queensland
屿	islet
巉	rugged
川滇藏	Sichuan
州立	state-run
巢	nest
工位	workstation
工作流	workflow
工作狂	workaholic
工作者	worker
工作表	worksheet
工作过度	overwork
工作量	workload
工具箱	toolbox
工坊	workshop
工时	man-hour
工程学	engineering
工笔	gongbi
工头	foreman
左口鱼	flounder
左右共利	ambidextrous
左撇子	left-hander
左氧氟沙星	levofloxacin
左至右	left-to-right
左轮手枪	revolver
巨乳	busty
巨噬细胞	macrophage
巨大	huge
巨石	boulder
巨石柱群	Stonehenge
巫术	witchcraft
差别	difference
差误	mistake
巯	hydrosulfuryl
已婚	married
已成形	preformed
已经	already
巴伐利亚	Bavaria
巴伦西亚	Valencia
巴克特里亚	Bactria
巴利文	Pali
巴力	Baal
巴勒斯坦	Palestine
巴勒莫	Palermo
巴基斯坦	Pakistan
巴塞尔	Basel
巴塞罗那	Barcelona
巴宰族	Pazeh
巴库	Baku
巴拉克	Barack
巴拉圭	Paraguay
巴拿马	Panama
巴斯特尔	Basseterre
巴林	Bahrain
巴枯宁主义	Bakuninism
巴格达	Baghdad
巴比伦	Babylon
巴氏	Pasteur
巴氏杀菌	pasteurization
巴乌	bawu
巴尔多禄茂	Bartholomew
巴尔干	Balkan
巴特纳	Batna
巴西	Brazil
巴西利亚	Brasilia
巴西战舞	capoeira
巴阿	Pakistan-Afghan
巴马科	Bamako
巴黎	Paris
市场化	marketization
市场营销	marketing
市长	mayor
布列塔尼	Brittany
布加勒斯特	Bucharest
布希威克	Bushwick
布干维尔	Bougainville
布拉德福德	Bradford
布拉格	Prague
布拉索夫	Braşov
布拉迪斯拉发	Bratislava
布料	fabric
布林迪西	Brindisi
布法罗	Buffalo
布洛芬	ibuprofen
布洒器	disperser
布尔什维克	Bolshevik
布尔乔亚	bourgeoisie
布尔诺	Brno
布痕瓦尔德	Buchenwald
布谷	cuckoo
布线	wiring
布莱克本	Blackburn
布莱顿	Brighton
布农族	Bunun
布达佩斯	Budapest
布达拉宫	Potala
布里斯托	Bristol
布里斯班	Brisbane
布里特妮	Britney
布隆方丹	Bloemfontein
布隆迪	Burundi
布鲁克林	Brooklyn
布鲁塞尔	Brussels
布鲁姆斯伯里	Bloomsbury
帆船	sailboat
希伯来	Hebrew
希尔弗瑟姆	Hilversum
希腊	Greece
帔	cape
帕利基尔	Palikir
帕尼巴特	Panipat
帕提亚人	Parthian
帕斯	Perth
帕皮提	Papeete
帕福斯	Paphos
帖撒罗尼迦	Thessalonica
帛	silk
帝	emperor
帝力	Dili
帝国主义	imperialism
帨	handkerchief
席凡宁根	Scheveningen
帐帘	drapery
带宽	bandwidth
带感	electrifying
带红色	reddish
带扣	buckle
常常	frequently
常春藤	ivy
常青	evergreen
帽匠	milliner
币种	currency
帮手	helper
幯	wipe
干系	responsibility
干扰素	interferon
平均主义	egalitarianism
平壤	Pyongyang
平常日	weekday
平流层	stratosphere
平白无故	inexplicably
平胸	flat-chested
平行四边形	parallelogram
平衡觉	equilibrioception
平谷区	Pinggu
平锅	pan
平顺	Pingshun
年少无知	unsophisticated
年年	yearly
年载	years
年轻	young
年青	youthful
幵	level
幻	fantasy
幻象	illusion
幼兽	cub
幼虫	larva
幽暗	gloom
幽闭恐惧症	claustrophobia
几丁质	chitin
几乎	almost
几何学	geometry
几内亚比绍	Guinea-Bissau
几进宫	recidivist
庇护所	shelter
床罩	bedspread
床虱	bedbug
床边	bedside
床铺	bed
序列	sequence
序幕	prologue
序曲	overture
序言	preface
底数	base
底栖生物	benthos
底漆	primer
底特律	Detroit
底盘	chassis
底部	bottom
度量衡	measurement
座椅	seat
座头市	Zatoichi
库仑计	voltameter
库伦	Kulun
库存	stock
库布里克	Kubrick
库拉索	Curaçao
库尔德斯坦	Kurdistan
库肯霍夫公园	Keukenhof
库页岛	Sakhalin
庭院	courtyard
康涅狄格	Connecticut
庸俗化	debasement
庸才	mediocrity
庸碌	mediocre
厢式车	van
廉价	cheaply-priced
厨	kitchen
厨司	chef
厨子	cook
庙口	Miaokou
庙宇	temple
废墟	ruins
广告主	advertiser
广告宣传	advertising
广告拦截器	ad-blocker
广告牌	billboard
广场	plaza
广子	ad
广岛	Hiroshima
广度	breadth
广式	Cantonese-style
广泛	wide
广为	widely
广袤	vast
延展性	ductability
延性	ductility
延庆区	Yanqing
建三江	Jiansanjiang
建筑师	architect
建党	party-founding
弓弦	bowstring
弓箭手	archer
引信	fuze
引火柴	kindling
引爆装置	detonator
引用句	quotation
引种	agriculture
弗拉基米尔	Vladimir
弗拉芒	Flemish
弗罗茨瓦夫	Wroclaw
弗莱福兰	Flevoland
弗里斯兰	Friesland
弗雷德里克顿	Fredericton
弟子	disciple
弧	arc
弧形	curve
弩	crossbow
弱视	amblyopia
张力	tension
张惠妹	A-Mei
张王李赵	anyone
强力	powerful
强力胶	superglue
强大	formidable
强奸犯	rapist
强奸罪	rape
弹丸	pellet
弹夹	magazine
弹子	towrope
弹指之间	instantly
弹片	shrapnel
弹珠台	pinball
弹痕累累	bullet-riddled
弹药	ammunition
弹跳板	springboard
弥勒	Maitreya
弥赛亚	Messiah
彗星	comet
形容词	adjective
形态发生素	morphogen
形而上学	metaphysics
形变	deformation
彩弹	paintball
彩泥	playdough
彪子	simpleton
彬	urbane
彬马那	Pyinmana
影院	cinema
影音	audiovisual
影响层面	impact
彼尔姆	Perm
征战	campaign
征服者	conqueror
很是	quite
律	law
律吕	tuning
律师	lawyer
后备	reserve
后备军	rearguard
后味	aftertaste
后效	after-effect
后殖民	postcolonial
后海	Houhai
后灯	taillight
后现代主义	postmodernism
后甲板	afterdeck
后裔	descendant
后制	postproduction
后见之明	hindsight
径流	runoff
径直	directly
徒劳	futile
徒步旅行	hiking
得中	moderate
得了	emphatically
得克萨斯	Texas
得可以	awfully
得票	vote-getting
从不	never
从俭	economical
从句	clause
从严	strict
从宽	lenient
从属	subordinate
从业者	practitioner
复活节	Easter
循道宗	Methodism
徬	irresolute
微不足道	negligible
微光	glimmer
微动开关	microswitch
微型	miniature
微妙	subtle
微晶	microcrystal
微生物	microorganism
微生物学	microbiology
微生物学家	microbiologist
微睡眠	microsleep
微秒	microsecond
微管蛋白	tubulin
微粒体	microsome
微丝	microfilament
微缩胶卷	microfilm
微胖	stoutish
微胶囊技术	microencapsulation
微处理器	microprocessor
微表情	microexpression
微观经济	microeconomic
微观经济学	microeconomics
微距	close-up
微醺	tipsy
微量白蛋白	microalbumin
微电子	microelectronics
微电脑	microcomputer
征状	symptom
德国	Germany
德国结	pretzel
德国酸菜	sauerkraut
德川	Tokugawa
德式	German-style
德意志	Deutschland
德雷斯顿	Dresden
德黑兰	Tehran
徽标	emblem
心伤	broken-hearted
心包	pericardium
心土	subsoil
心弦	heartstrings
心律不齐	arrhythmia
心悸	palpitation
心爱	beloved
心慈手软	merciful
心狠手辣	merciless
心理学	psychology
心理学家	psychologist
心目	mind
心硬	hard-hearted
心累	drained
心结	preoccupation
心绞痛	angina
心肌	myocardium
心肌炎	myocarditis
心肝宝贝	sweetheart
心肺	cardiopulmonary
心胸狭窄	petty
心腹	confidant
心血管	cardiovascular
心跳过缓	bradycardia
心防	guardedness
心灵上	spiritual
心灵感应	telepathy
必备	essential
必杀技	finisher
必要性	necessity
忉	grieved
忍者	ninja
忐忑	apprehensive
志愿者	volunteer
忘性	forgetfulness
忙碌	busy
忠	loyal
忠实	faithful
快可立	Quickly
快手	Kuaishou
快板	allegro
快乐	happy
快当	quick
快讯	newsflash
快转	fast-forward
快速	fast
快递员	courier
快门	shutter
念力	psychokinesis
念头	thought
忽地	suddenly
怎	how
怏	discontented
怒气	anger
怒冲冲	furiously
思想家	thinker
思想意识	consciousness
思觉失调	psychosis
思路敏捷	quick-witted
思乡病	homesickness
怠惰	idleness
怡人	delightful
急公好义	public-spirited
急剧	rapid
急忙	hastily
急流	torrent
急着	urgently
性事	sex
性交高潮	orgasm
性冷淡	frigidity
性命	life
性子	temper
性学	sexology
性急	impatient
性短讯	sext
性腺	gonad
怨尤	resentment
怨毒	rancor
怨言	complaint
怯懦	timid
恒定	constant
恒心	perseverance
恒温器	thermostat
恉	purport
恐同症	homophobia
恐怖主义	terrorism
恐怖分子	terrorist
恐惧症	phobia
恐韩症	Koreaphobia
恐龙总目	Dinosauria
恐龙类	dinosaurs
恙	sickness
恚	rage
恟	scared
恢复期	convalescence
耻	humiliation
恩公	benefactor
恩斯赫德	Enschede
恩贾梅纳	N'Djamena
恫	frighten
恭	respectful
恭谨	deferential
恰吉	Chucky
恰帕斯州	Chiapas
悄悄咪咪	stealthily
悦	pleased
悉尼	Sydney
悍勇	intrepid
悔意	remorse
悚	frightened
悜	obscure
悠扬	melodious
患者	patient
悲剧性	tragic
悲喜剧	tragicomedy
悲苦	forlorn
悲观	pessimistic
怅	regretful
闷声闷气	muffled
悻然	angrily
凄怆	pitiful
凄凉	mournful
情侣鹦鹉	lovebirds
情境	situation
情急	anxious
情意	affection
情景喜剧	sitcom
情真意切	heartfelt
情谊	friendship
惠普	Hewlett-Packard
惠誉	Fitch
惠灵顿	Wellington
恶名昭著	infamous
恶唑啉	oxacillin
恶性通货膨胀	hyperinflation
恶毒	malicious
恼火	annoyed
想家	homesick
想象力	imagination
惶	dread
惶恐	terrified
恻隐之心	compassion
愁绪	melancholy
愉快	cheerful
意外事故	accident
意大利	Italy
意大利面	spaghetti
意式	Italian-style
意志	will
意志力	willpower
意念移物	telekinesis
意气相投	congenial
意识形态	ideology
愓	profligate
愚鲁	dull-witted
爱丁堡	Edinburgh
爱哭鬼	crybaby
爱国主义	patriotism
爱国者	patriot
爱奇艺	iQiyi
爱好者	amateur
爱彼迎	Airbnb
爱意	love
爱斯基摩	Eskimo
爱普生	Epson
爱沙尼亚	Estonia
爱尔兰	Ireland
爱留根纳	Eriugena
爱维养	Evian
爱荷华	Iowa
爱莫利维尔	Emeryville
爱词霸	iCIBA
爱达荷	Idaho
惬	content
惬意	satisfied
感人	touching
感光	light-sensitive
感知力	perceptivity
慅	agitated
慆	rejoice
慇	solicitous
慈善机构	charity
慈悲	mercy
慕田峪	Mutianyu
惨重	disastrous
恸	grief
慢	slow
慢化剂	moderator
慢慢	slowly
慧	intelligent
虑病症	hypochondria
悭俭	miserly
慵	lethargic
庆典	celebration
欲望	desire
忧灼	worrying
凭空捏造	frame-up
憩室炎	diverticulitis
憪	composed
憬	awaken
宪政主义	constitutionalism
憺	peace
应激源	stressor
应变力	adaptability
懔	fear
懑然	dejectedly
懦	faint-hearted
懦弱	cowardly
惩罚性	punitive
懒	lazy
懒人沙发	beanbag
懒散	indolent
懒洋洋	lazily
怀俄明	Wyoming
怀柔区	Huairou
悬挂式滑翔	hang-gliding
悬挂式滑翔机	hang-glider
悬疑	suspense
悬臂	cantilever
惧内	henpecked
惧高症	acrophobia
恋尸癖	necrophilia
恋童犯	pedophile
恋童癖	pedophilia
戈斯拉尔	Goslar
成化	Chenghua
成千	thousands
成员	member
成年者	adult
成心	intentionally
成文法	statute
成本	manufacturing
成核	nucleation
成瘾性	addictiveness
我	I
我们	we
戒备森严	heavily-guarded
戒命	prohibition
戒惧	wary
戒断	withdrawal
或然	probable
截夺	intercept
截止期限	deadline
截然	sharply
战列舰	battleship
战地	battlefield
战斧	battle-ax
战时	wartime
战无不胜	invincible
战略	strategy
战略性	strategic
战术	tactics
战马	warhorse
战斗者	fighter
戏剧化	theatrical
戏剧性	dramatic
戏台	stage
戏院	theater
戴安娜王妃	Diana
戴尔	Dell
户外	outdoor
房客	tenant
房室	room
房山区	Fangshan
房东	landlord
房檐	eaves
所在地	location
所多	Soto
扁圆	oblate
扁桃体	tonsil
扁桃体炎	tonsillitis
扁虫	flatworm
扈	retinue
手倒立	handstand
手册	manual
手刹	handbrake
手势	gesture
手包	handbag
手写体	cursive
手工业	handicraft
手工台	workbench
手忙脚乱	flustered
手拉车	cart
手提箱	suitcase
手摇	hand-cranked
手腕子	wrist
手自一体	manumatic
手锯	handsaw
手镯	bracelet
手雷	grenade
手风琴	accordion
扎伊尔	Zaire
扒手	pickpocket
扒钉	cramp
打千	genuflection
打印机	printer
打字员	typist
打字机	typewriter
打火石	flint
托儿所	nursery
托勒密王	Ptolemy
托尼老师	hairdresser
托尔斯港	Tórshavn
托皮卡	Topeka
托育	childcare
托莱多	Toledo
托叶	stipule
扢	sprightful
扯裂	rip
扶他林	voltaren
扶南	Funan
扶手椅	armchair
扶桑	Fusang
扶栏	handrail
批评家	critic
承包商	contractor
承销店	dealership
技	skill
技术官僚	technocrat
把拔	daddy
抑制作用	inhibition
抑扬格	iambic
抑郁	depressed
抓力	grip
抓地力	traction
抓大放小	PRC
投影仪	projector
投票者	voter
投资人	investor
抖音	Douyin
抗倾覆	anticapsizing
抗凝血剂	anticoagulant
抗毒素	antitoxins
抗氧化剂	antioxidant
抗生素	antibiotic
抗病毒	antiviral
抗病毒药	antivirals
抗癌	anti-cancer
抗血清	antiserum
抗议者	protester
抗锯齿	anti-aliasing
折光	refraction
折扣	discount
折皱	fold
折旧	depreciation
折衷主义	eclecticism
披巾	shawl
押沙龙	Absalom
抽屉	drawer
抽脂	liposuction
拂扫	whisk
拇指甲	thumbnail
拉克替醇	lactitol
拉包尔	Rabaul
拉夫堡	Loughborough
拉奎拉	L'Aquila
拉姆安拉	Ramallah
拉巴特	Rabat
拉拉	Lala
拉斐尔	Raphael
拉斐特	Lafayette
拉法兰	Raffarin
拉法赫	Rafah
拉脱维亚	Latvia
拉达克	Ladakh
拉链	zipper
拉风	trendy
拊	pat
抛射物	projectile
抛物线	parabola
拓展坞	dock
拔染	discharge
拔示巴	Bathsheba
拖延症	procrastination
拖把	mop
拖曳伞	parasail
拖曳机	tractor
拖沓	dilatory
拖轮	tugboat
拗口	awkward-sounding
拘役	detention
拘束衣	straightjacket
拙劣	clumsy
招待所	guesthouse
招聘者	recruiter
招股说明书	prospectus
拜物教	fetishism
括毒	spiteful
括约肌	sphincter
拱度	camber
拱形	arch
拱道	archway
拱点	apse
拳击	boxing
拳击手	boxer
拼多多	Pinduoduo
拼法	spelling
拿不准	indecisive
持份者	stakeholder
持卡人	cardholder
持有人	holder
指尖	fingertip
指挥官	commander
指挥棒	baton
指甲	fingernail
指示器	indicator
指关节	knuckle
按手礼	ordination
按摩师	masseur
按摩棒	vibrator
按摩浴缸	jacuzzi
按时间先后	chronological
按理	normally
按说	ordinarily
挎斗	sidecar
挑战者	challenger
挑衅	provocation
挖掘机	excavator
挖泥船	dredger
挨着	near
挪威	Norway
挫折感	frustration
振幅	amplitude
振荡器	oscillator
捆缚	bondage
捉摸不定	elusive
捐赠者	donor
捕手	catcher
捕禽人	birdcatcher
捕鲸船	whaler
捕鸟蛛	tarantula
捕鼠器	mousetrap
捘	push
卷带	tape
捷径	shortcut
捷尔任斯克	Dzerzhinsk
掀天揭地	earth-shattering
掀背车	hatchback
扫帚	broom
扫描器	scanner
扫雷舰	minesweeper
授精	insemination
掌故	anecdote
掌柜	shopkeeper
掎	drag
排枪	salvo
排水渠	drainage
排水沟	gutter
排水量	displacement
排泄物	excreta
排湾族	Paiwan
排版	typesetting
排箫	panpipes
挂坠盒	locket
挂绳	lanyard
挂车	trailer
挂锁	padlock
采暖	heating
采样	sampling
采矿	mining
探测器	detector
探照灯	searchlight
探索性	exploratory
探路者	Pathfinder
探针	probe
探险家	explorer
接力	relay
接合菌纲	Zygomycetes
接待员	receptionist
接收器	receiver
接生婆	midwife
接触器	contactor
接连不断	continuous
推力	impetus
推土机	bulldozer
推斥	repulsion
推理小说	whodunit
措置裕如	effortless
措辞强硬	strongly-worded
掾	official
揃	shear
提克里特	Tikrit
提心吊胆	fearful
提摩太	Timothy
提案人	proposer
提示音	beep
提线木偶	marionette
提词器	teleprompter
提醒物	reminder
插头	plug
扬抑格	trochaic
扬声器	speaker
揪心揪肺	heart-wrenching
损耗品	consumables
搓衣板	washboard
摇光	Alkaid
摇杆	joystick
摇篮曲	lullaby
摇号	lottery
搜狐	Sohu
搜狗	Sogou
搬运工	porter
抢劫罪	robbery
摁扣儿	popper
摩亨佐·达罗	Moenjo-daro
摩加迪沙	Mogadishu
摩德纳	Modena
摩托罗拉	Motorola
摩托艇	motorboat
摩揭陀	Magadha
摩擦力	friction
摩洛哥	Morocco
摩尔多瓦	Moldova
摩纳哥	Monaco
摩羯座	Capricornus
摩萨德	Mossad
摩西	Moses
折纸	origami
撇去	skim
撇号	apostrophe
撑杆跳	pole-vaulting
撒哈拉	Sahara
撒哈拉以南	sub-Saharan
撒哈拉威	Sahrawi
撒拉语	Salar
撒都该人	Sadducees
撒马利亚	Samaria
撒马尔罕	Samarkand
撞锁	lock
拨奏	pizzicato
拨火棍	poker
拨片	plectrum
拨用	appropriation
抚抱	caress
撬棍	crowbar
播报员	announcer
播放列表	playlist
撼天动地	earth-shaking
捡骨	bone-gathering
擂茶	"leicha"
擅断	arbitrary
击球员	baseball
挡泥板	mudguard
操作员	operator
操舵室	pilothouse
担架床	stretcher
担惊受怕	alarmed
擖	scrape
据此	accordingly
据说	reportedly
挤踏	stampede
擦音	fricative
拟声词	onomatopoeia
拟卤素	pseudohalogen
搁板	shelf
搁脚板	footrest
摆线	cycloid
攃	preceding
摄影师	photographer
摄影术	photography
摄影记者	photojournalist
摄政王	regent
支付宝	Alipay
支光	watt
支座	abutment
支持者	supporter
支撑架	bracket
支族	subfamily
支气管炎	bronchitis
收件箱	inbox
收割者	reaper
收容人	inmate
收成	harvest
收货人	consignee
收费站	tollbooth
收银员	cashier
改革家	reformer
放任政策	non-interference
放大器	amplifier
放射免疫测定	radioimmunoassay
放射学	radiology
放射性	radioactive
放射性活度	radioactivity
放射治疗	radiotherapy
放松管制	deregulation
放荡不羁	dissolute
政事	politics
政客	politician
政治局	politburo
政治性	political
故事线	storyline
故意	deliberately
效率	efficiency
敏锐	keen
救兵	reinforcements
救星	savior
救生员	lifeguard
救生船	lifeboat
救赎主	Redeemer
败家子	spendthrift
败血症	septicaemia
叙事	narrative
叙利亚	Syria
教仪	ordinance
教务长	provost
教堂墓地	churchyard
教宗	pope
教宗座驾	popemobile
教本	textbook
教条主义	dogmatism
教母	godmother
教父	godfather
教皇	pontiff
教众	followers
教育学	pedagogy
教育家	educationalist
教育工作者	educator
敞开儿	unrestrictedly
散光	astigmatism
散职	sinecure
散逸层	exosphere
敦刻尔克	Dunkirk
敦豪	DHL
敬意	respect
敬虔	devout
敲诈罪	extortion
敌基督	Antichrist
敌意	enmity
敌方	enemy
数不胜数	innumerable
数不清	countless
数字命理学	numerology
数学	mathematics
数学家	mathematician
数得着	notable
数据	data
数据手册	datasheet
数据集	dataset
数码港	Cyberport
数词	numeral
文具商	stationer
文员	clerk
文字学	philology
文凭	diploma
文抄公	plagiarist
文旦	pomelo
文明化	civilize
文档	document
文盲	illiterate
文胸	bra
文莱	Brunei
斐济	Fiji
斑疹伤寒	typhus
斑马鱼	zebrafish
斑驳陆离	variegated
斑鸠	turtledove
料件子活	piecework
斜体字	italics
斧	hatchet
斨	axe
斯堪的纳维亚	Scandinavia
斯多葛主义	Stoicism
斯大林主义	Stalinism
斯巴达	Sparta
斯巴鲁	Subaru
斯德哥尔摩	Stockholm
斯拉夫	Slavic
斯普林菲尔德	Springfield
斯普特尼克	Sputnik
斯柯达	Škoda
斯洛文尼亚	Slovenia
斯特拉斯堡	Strasbourg
斯瓦希里	Swahili
斯雷布雷尼察	Srebrenica
新冠肺炎	COVID-19
新加坡	Singapore
新古典	neoclassical
新古典主义	neoclassicism
新娘	bride
新字体	shinjitai
新宿	Shinjuku
新教	Protestantism
新殖民主义	neocolonialism
新殖民化	neocolonialization
新浪	Sina
新潟	Niigata
新石器	Neolithic
新竹市	Hsinchu
新义州市	Shin'ŭiju
新闻学	journalism
新闻发言人	spokesman
新闻组	newsgroup
新闻记者	journalist
新艺拉玛	Cinerama
新艺综合体	CinemaScope
新西伯利亚市	Novosibirsk
新近	newly
新郎	bridegroom
断续	intermittent
𣃁	cut
方位角	azimuth
方尖碑	obelisk
方帽	mortarboard
方方正正	square-shaped
方法学	methodology
方舟	ark
方铅矿	galena
方头巾	headscarf
于是	thereupon
于是乎	therefore
施事者	doer
施政	administration
施教	teaching
施乐	Xerox
施洗	baptize
施虐受虐	sado-masochism
旁边	side
旅客	traveler
旅程表	itinerary
旅舍	inn
旅途	journey
旋律	melody
旋涡状	spiral-shaped
旋花科	Convolvulaceae
旖旎	enchanting
旗杆	flagpole
旗舰	flagship
旗袍	cheongsam
旗语	semaphore
既有	existing
既然	since
日中	Japan-China
日光	sunlight
日光浴	sunbathing
日光浴浴床	sunbed
日内瓦	Geneva
日冕	corona
日出	sunrise
日常	day-to-day
日常工作	routine
日晷	sundial
日暮	sunset
日晒伤	sunburn
日本	Japan
日本共同社	Kyōdō
日本学	Japanology
日立	Hitachi
日美	Japan-US
日耳曼	Germanic
日间	daytime
旦角	dan
早前	previously
早午饭	brunch
早场	matinee
早搏	extrasystole
早熟	precocious
早老素	presenilins
早点	breakfast
旱	drought
旱獭	marmot
旱鸭子	non-swimmer
旺炽	blazing
昆虫学	entomology
昌平区	Changping
昌迪加尔	Chandighar
明信片	postcard
明喻	simile
明天	tomorrow
明尼苏达	Minnesota
明尼阿波利斯	Minneapolis
明斯克	Minsk
明治	Meiji
明胶	gelatin
明虾	prawn
明里	publicly
昏庸	muddleheaded
昏暗	dusky
易感	susceptible
易挥发	volatile
易损性	vulnerability
易洛魁	Iroquois
易激惹	irritable
易爆	explosive
易腐败	perishable
易趣	EachNet
易游网	ezTravel
星光	starlight
星冰乐	Frappuccino
星巴克	Starbucks
星斗	stars
星期一	Monday
星期三	Wednesday
星期二	Tuesday
星期五	Friday
星期四	Thursday
星期日	Sunday
星云	nebula
星驰	rapidly
春季	springtime
春日部	Kasukabe
春药	aphrodisiac
春黄菊属	Anthemis
昨天	yesterday
时代	Time
时代曲	shidaiqu
时常	often
时延	latency
时而	occasionally
时钟	clock
时长	duration
时间戳	timestamp
时间测定学	chronometry
时间线	timeline
晌午	noon
晚晌	evening
昼行性	diurnality
普列谢茨克	Plesetsk
普利茅斯	Plymouth
普契尼	Puccini
普惠	inclusive
普林斯顿	Princeton
普罗夫迪夫	Plovdiv
普罗米修斯	Prometheus
普罗维登斯	Providence
普适	universal
普雷克斯流程	purex
普雷斯顿	Preston
普鲁东主义	Proudhonism
景色	scenery
景观	landscape
晶体	crystal
晶体管	transistor
智利	Chile
智性恋	sapiosexuality
智慧	wisdom
智神星	Pallas
智能手机	smartphone
智能手表	smartwatch
智谋	resourcefulness
晾衣绳	clothesline
暌隔	parted
暍	hot
暖化	warming
暖意	warmth
暗堡	bunker
暗室	darkroom
暗流	undercurrent
暗里	privately
畅通	unobstructed
暂且	temporarily
暂时	temporary
暂行	provisional
暮色	twilight
暴光	exposure
暴戾	ruthless
暴虐无道	oppressive
暴躁	irascible
暴露狂	exhibitionist
暴露癖	exhibitionism
暴龙科	Tyrannosauridae
历	calendar
晒娃	sharenting
曲度	curvature
曲线锯	jigsaw
曲轴	crankshaft
曲霉毒素	aspergillus
书法家	calligrapher
书虫	bookworm
书记处	secretariat
书面	written
曼妥思	Mentos
曼尼托巴	Manitoba
曼德勒	Mandalay
曼彻斯特	Manchester
曼海姆	Mannheim
曼谷	Bangkok
曾孙	great-grandson
曾孙女	great-granddaughter
曾祖父母	great-grandparents
替罪羊	scapegoat
最低点	nadir
最喜爱	favorite
最年长	eldest
最后通牒	ultimatum
最终	final
会厌	epiglottis
会厌炎	epiglottitis
会客厅	parlor
会死	mortal
会漏	leak
会计师	accountant
月亮女神号	SELENE
月份	month
月光	moonlight
月光石	moonstone
月子	puerperium
月度	monthly
月牙形	crescent
月琴	yueqin
有一点	somewhat
有人情	humane
有价值	valuable
有利	advantageous
有利可图	profitable
有创造力	ingenious
有型	stylish
有孔虫	foraminifera
有帮助	helpful
有影响	influential
有意识	conscious
有才干	capable
有排面	showy
有攻击性	offensive
有效性	validity
有效负载	payload
有料	impressive
有时候	sometimes
有条纹	striped
有机	organic
有机玻璃	plexiglass
有机磷酸酯类	organophosphate
有机体	organism
有权威	authoritative
有次	once
有次序	ordered
有毒	poisonous
有气派	lordly
有气无力	dispirited
有气质	classy
有氧运动	aerobics
有决心	determined
有用	useful
有界	bounded
有益处	beneficial
有精神病	insane
有丝分裂	mitosis
有罪	guilty
有罪不罚	impunity
有声书	audiobook
有能力	able
有胆量	courageous
有良心	conscientious
有色眼镜	prejudice
有卖相	appealing
有轨电车	streetcar
有道理	reasonable
有阴影	shadowy
有预谋	premeditated
有风	windy
朋	friend
朋党	clique
朝圣者	pilgrim
朝着	towards
期刊	periodical
木偶	puppet
木刻	woodcut
木匠	carpenter
木卡姆	muqam
木吒	Muzha
木柴	firewood
木桶	cask
木炭	charcoal
木犀	osmanthus
木琴	xylophone
木瓦	shingle
木糖醇	xylitol
木聚糖	xylan
木薯	cassava
木薯淀粉	tapioca
木兰属	Magnolia
木兰科	Magnoliaceae
木制	wooden
木质素	lignin
木质部	xylem
木钉	peg
未卜	unknowable
未婚	unmarried
未婚夫	fiancé
未婚妻	fiancée
未定	undecided
未成	incomplete
未成年	underage
未熟	unripe
未知	unknown
未经证实	unconfirmed
末后	finally
末日论	eschatology
本尼迪	Benedictus
本州	Honshū
本底	background
本影	umbra
本能	instinct
本那比市	Burnaby
本体论	ontology
札幌	Sapporo
札格雷布	Zagreb
朱红	vermilion
朽坏	rotten
朿	stab
杆子	pole
李	plum
李木	blackthorn
李氏朝鲜	Joseon
杏子	apricot
杏眼	large
村子	village
村民	villager
村舍	cottage
杜尚别	Dushanbe
杜蕾斯	Durex
杜马	Duma
束腰	girdle
束身内衣	corset
东仓里	Dongchang-ni
东北	northeast
东南	southeast
东城区	Dongcheng
东方	east
东洋鬼子	Nip
东芝	Toshiba
东道	host
杳无人迹	uninhabited
杻	handcuffs
松科	pinaceae
松节油	turpentine
松鸡	grouse
松露	truffle
松鹤遐龄	longevity
松鼠	squirrel
板岩	slate
板条	lath
板条箱	crate
板状	board-shaped
板车	handcart
板门店	Panmunjeom
枕套	pillowcase
枕头	pillow
林可霉素	lincomycin
林地	woodland
林学	forestry
林荫道	boulevard
林雪平	Linköping
果仁密饼	baklava
果倍爽	Capri-Sun
果品	fruit
果园	orchard
果子冻	jelly
果糖	fructose
果肉	pulp
果胶	pectin
果酱	jam
果馅饼	tart
枯干	shriveled
枯燥	uninteresting
枯萎病	blight
柏拉图哲学	Platonism
柏林	Berlin
某时	sometime
某物	something
某处	somewhere
柑橘	citrus
柑橘酱	marmalade
染毒	contamination
染色	dye
染色体	chromosome
柔道	judo
柘榴石	garnet
查尔斯	Charles
查尔斯顿	Charleston
查韦斯	Chavez
柩	bier
柬埔寨	Cambodia
柯夫塔	kofta
柯尼斯堡	Königsberg
柱梁	pillar
柳条	osier
柳树	willow
栅栏	fence
柿	persimmon
栗子	chestnut
校园	campus
校订	revision
栩栩	vivid
栱	post
栲属	Castanopsis
核合成	nucleosynthesis
核小体	nucleosome
核心	core
核糖	ribose
核糖体	ribosome
核苷	nucleoside
核苷酸	nucleotide
核碱基	nucleobase
根基	foundation
根特	Ghent
根须	roots
格但斯克	Gdansk
格子呢	plaid
格子棉布	gingham
格子花呢	tartan
格子间	cubicle
格拉斯哥	Glasgow
格拉纳达	Granada
格林多	Corinthians
格林威治	Greenwich
格林纳达	Grenada
格栅	grille
格格笑	giggle
格罗宁根	Groningen
格罗兹尼	Grozny
格言	maxim
格陵兰	Greenland
桃子	peach
桃花心木	mahogany
桅杆	mast
案文	text
桉树	eucalyptus
桌上型	desktop
桎	fetters
桑给巴尔	Zanzibar
桶孔	bunghole
梁赞	Ryazan
梁龙	diplodocus
梅林	Merlin
梅毒	syphilis
梐	stockade
梗概	gist
条件式	conditional
条例	regulations
条形码	barcode
条纹	stripe
梧桐科	Sterculiaceae
梨俱吠陀	Rigveda
梨属	Pyrus
梨果	pome
梯	stairs
梯度	gradient
梯板	gangplank
梵教	Brahmanism
梵文	Sanskrit
梵书	Brahmana
棉花	cotton
棋盘	chessboard
棍子	stick
棍棒	club
棍网球	lacrosse
棒冰	popsicle
棕色	brown
棘	thorns
棘皮动物	echinoderm
棘轮	ratchet
棚户区	shantytown
棠	cherry-apple
栈主	innkeeper
栈架	trestle
棬	bowl
森美兰	Sembilan
栖息地	habitat
棺	coffin
椅	chair
植树造林	afforestation
植物化学成分	phytochemical
植物学	botany
植物学家	botanist
植物群	flora
椓	beat
椪柑	ponkan
杨	poplar
枫树	maple
楔形物	wedge
业务员	salesperson
业余爱好者	hobbyist
楮纸	kozogami
极其	extremely
极化	polarization
极权	totalitarian
极权主义	totalitarianism
极端	extreme
极端主义	extremism
极端分子	extremist
极简主义	minimalism
极道	yakuza
概念化	conceptualization
概括化	generalization
概要	outline
概述	overview
榆树	elm
榕树	banyan
榛子	hazelnut
榛色	filbert
榨酒池	winepress
杩	headboard
荣光	glory
荣市	Vinh
荣耀	honor
榴弹炮	howitzer
槌球	croquet
枪子	bullet
枪法	marksmanship
杠铃	barbell
槲寄生	mistletoe
桨手	rower
槽位	slot
乐	music
乐事	pleasure
乐园	paradise
乐学者	musicologist
乐感	musicality
乐观	optimistic
乐观主义	optimism
乐趣	delight
乐颠了馅	ecstatic
乐高	Lego
枞树	fir
楼下	downstairs
楼宇	building
楼厢	loft
樕	shrub
樗	simaroubaceae
标枪	javelin
标准化	standardization
标牌	label
标号	grade
标志性	iconic
标语牌	placard
枢垣	censorate
枢轴	pivot
樟宜	Changi
模仿品	counterfeit
模块化	modularity
模块式	modular
模式	mode
模形	pattern
模拟器	emulator
样品	sample
样机	prototype
样貌	appearance
樵子	woodcutter
朴实无华	plain
朴次茅斯	Portsmouth
树冠	treetop
树熟	tree-ripe
树篱	hedge
树脂	resin
树苗	sapling
树袋熊	koala
桦木	birch
橙子	orange
机制	mechanism
机器人	robot
机器人学	robotics
机密性	confidentiality
机敏	agility
机械工人	mechanic
机械性	mechanical
机壳	case
机要	classified
机遇	opportunity
机长	captain
机关车	locomotive
橡木	oaken
橡树	oak
橡胶	rubber
椭	ellipse
椭圆形	oval
横截面	cross-section
横梁	beam
横楣	lintel
横滨	Yokohama
横筋斗	cartwheel
横纲	yokozuna
横膈	diaphragm
横竖	anyway
檀君	Tangun
檀香	sandalwood
柽	tamarisk
檐廊	veranda
档案	file
档案夹	portfolio
检查员	inspector
检查站	checkpoint
检疫	quarantine
檨	mango
台布	tablecloth
柠檬	lemon
柠檬水	lemonade
柜员	teller
棂	latticework
樱岛	Sakurajima
樱桃	cherry
樱花草	primrose
欂	rafter
栏架	hurdle
权宜	expedient
权杖	scepter
权柄	authority
𪴙	gather
欙	sedan
次方言	subdialect
次等	second-class
次要	secondary
欸	eh
欺诈者	deceiver
欼	drink
歈	songs
歌后	diva
歌手	singer
歌曲	song
歌罗西	Colossia
歌舞伎	kabuki
欧亚大陆	Eurasia
欧元区	Eurozone
欧柏林	Oberlin
欧若拉	Aurora
欧蝶鱼	plaice
止汗剂	anti-perspirant
止痛片	painkiller
正交	orthogonality
正仓院	Shōsō-in
正型标本	holotype
正字法	orthography
正式	formal
正方形	square
正牌	genuine
正畸	orthodontics
正确	correct
正负号	±
此	this
此外	besides
步法	footwork
步测	pacing
步行者	pedestrian
步话机	walkie-talkie
武器级	weapons-grade
武士刀	katana
武装分子	gunman
歪歪扭扭	crooked
历史学	history
历史学家	historian
历史性	historic
历史遗产	heritage
归化	naturalization
死心塌地	unswerving
死产	stillbirth
死藤水	ayahuasca
死飞	fixie
殑	swoon
殖民主义	colonialism
殖民地	colony
残次	defective
残毒	cruelty
残障	handicapped
殡仪员	mortician
杀千刀	damn
杀婴	infanticide
杀真菌剂	fungicide
杀草快	diquat
杀虫药	insecticide
殿军	runner-up
毁损	impair
母乳喂养	breastfeeding
母权制	matriarchy
母系社会	matrilineality
母细胞	matricyte
母驴	jenny
每个	each
每夜	nightly
毒力	virulence
毒性	toxicity
毒液	venom
毒理学	toxicology
毒莠定	picloram
毒药	poison
毒蛇	viper
毓婷	Yuting
比亚	Bia
比亚韦斯托克	Białystok
比什凯克	Bishkek
比值	ratio
比利时	Belgium
比哈尔邦	Bihar
比埃兹巴伯	Beelzebub
比安	Bienne
比绍	Bissau
比萨	Pisa
毛利人	Maori
毛刷	brush
毛哔叽	serge
毛孔	pore
毛毛的	unnerved
毛毛虫	caterpillar
毛毯	blanket
毛毡	felt
毛派	Maoist
毛泽东主义	Maoism
毛织运动衫	jersey
毛茛	buttercup
毛茸茸	hairy
毛象	mammoth
毛里塔尼亚	Mauritania
毛里求斯	Mauritius
毛发	hair
毛霉菌病	mucormycosis
毫克	milligram
毫升	milliliter
毫安	milliampere
毫瓦	milliwatt
毫秒	millisecond
毫米	millimeter
毹	rug
毽	shuttlecock
氅	overcoat
氏族	clan
民主主义者	democrat
民俗学	folklore
民族志	ethnography
民族自决	self-determination
民营化	privatization
民粹主义	populism
氘核	deuteron
氛围	ambience
氟化物	fluoride
气不公	indignant
气候学	climatology
气凝胶	aerogel
气动	pneumatic
气味	odor
气喘喘	breathless
气压计	barometer
气宇	bearing
气密	airtight
气旋	cyclone
气冲牛斗	infuriated
气溶胶	aerosol
气球	balloon
气筒	inflator
气象学	meteorology
氧乙炔	oxyacetylene
氧化物	oxide
氧合器	oxygenator
氧气	oxygen
氨	ammonia
氨基甲酸酯类化合物	carbamate
氪气石	kryptonite
氢化	hydrogenation
氢氟烃	hydrofluorocarbon
氢氧	oxyhydrogen
氮气	nitrogen
氯丁橡胶	neoprene
氯化物	chloride
氯化苦	chloropicrin
氯气	chlorine
氯痤疮	chloracne
氰化物	cyanide
氰基细菌	cyanobacteria
氰酸盐	cyanate
水上飞板	flyboard
水上飞机	seaplane
水刑逼供	water-boarding
水力学	hydraulics
水力发电	hydroelectricity
水印	watermark
水垢	limescale
水培法	hydroponics
水基	water-based
水塘	pool
水彩	watercolor
水患	flooding
水文	hydrology
水杉	metasequoia
水桶	bucket
水槽	sink
水潭	pond
水獭	otter
水田芥	watercress
水疱	blister
水磨石	terrazzo
水禽	waterfowl
水洼	puddle
水管工	plumber
水纹	ripples
水翼船	hydrofoil
水肺	scuba
水蒸气	vapor
水蛭素	hirudin
水行侠	Aquaman
水豚	capybara
水路	waterway
水银	mercury
水雾	mist
水鸟	waterbird
永冻土	permafrost
永定门	Yongdingmen
永无止境	never-ending
氹仔	Taipa
汗津津	sweaty
汗液	sweat
汗褂儿	undershirt
汝	thou
汞齐	amalgam
江河	river
江湖医生	quack
江畔	riverbank
污垢	dirt
污染物	pollutant
污水	sewage
污水坑	cesspit
污渍	stain
污痕	blot
污言秽语	obscenities
污迹	blotch
汭	river-bend
决定论	determinism
决策者	policymaker
汽油	gasoline
汽车旅馆	motel
沃尔夫	Wolf
沃尔夫斯堡	Wolfsburg
沃尔玛	Wal-Mart
沃尔芬森	Wolfson
沃罗涅日	Voronezh
沉浸式	immersive
沉淀物	precipitate
沉甸甸	heavy
沉积物	sediment
没	not
没有品味	tasteless
没有形状	shapeless
没用	useless
没经验	inexperienced
冲冲	excitedly
冲绳	Okinawa
沙利度胺	thalidomide
沙哑	hoarse
沙堡	sandcastle
沙威玛	shawarma
沙文主义	chauvinism
沙暴	sandstorm
沙棘	sea-buckthorn
沙沙	rustle
沙琪玛	sachima
沙眼	trachoma
沙虫	sandworm
沙质	sandy
沙锤	maraca
沙门氏菌	Salmonella
沙门菌	salmonella
沙鼠	gerbil
河内	Hanoi
河卵石	pebble
河川	rivers
河床	riverbed
河漫滩	floodplain
河滩	strand
河童	kappa
河豚	blowfish
河马	hippopotamus
沴	miasma
沸石	zeolite
油光漆	varnish
油旋	Youxuan
油桃	nectarine
油油	oily
油纸	oilpaper
治疗师	therapist
治愈系	uplifting
沿海	coastal
泄泻	diarrhea
泉路	netherworld
泌乳	lactation
泌尿	urination
泌尿外科	urology
法令	decree
法利赛人	Pharisee
法国	France
法国百合	artichoke
法塔赫	Fatah
法外	extrajudicial
法定	statutory
法式	French-style
法律责任	liability
法拉	farad
法拉利	Ferrari
法槌	gavel
法王	Sakyamuni
法兰克福	Frankfurt
法西斯主义	fascism
法警	bailiff
泛光灯	floodlight
泛性恋	pansexuality
泛神论	pantheism
泛自然神论	pandeism
泡沫塑料	styrofoam
泡泡	bubbles
泡泡口香糖	bubble-gum
波来古	Pleiku
波动性	fluctuation
波哥大	Bogota
波塞冬	Poseidon
波士顿	Boston
波季	Poti
波提乏	Potiphar
波斯	Persia
波斯尼亚	Bosnia
波旁	Bourbon
波浪	wave
波尔多	Bordeaux
波特率	baud
波状	wave-shaped
波状云	undulatus
波罗的	Baltic
波美拉尼亚	Pomerania
波兰	Poland
波谷	trough
波长	wavelength
泥	restrained
泥土	earth
泥敷剂	poultice
泥水匠	mason
泥沼	swamp
泥浆	slurry
泥潭	quagmire
泥煤	peat
泥质页岩	mudstone
泥铲	trowel
注册人	registrant
注意力	attention
泫	weep
泰国	Thailand
泰坦巨龙	titanosaur
泰米尔	Tamil
泳衣	swimsuit
洋灰	cement
洋琵琶	mandolin
洋红	carmine
洋罪	torture
洋芫荽	parsley
洋碱	soap
洗涤桶	washtub
洗洁剂	detergent
洗碗机	dishwasher
洗衣	laundry
洗发乳	shampoo
洛克菲勒	Rockefeller
洛基	Loki
洛锡安区	Lothian
洞孔	hole
洞察力	insight
津岛	Tsushima
津巴布韦	Zimbabwe
津贴	allowance
洪亮	resonant
洪堡	Humboldt
洪水	deluge
洪灾	flood
洪都拉斯	Honduras
洪雅族	Hoanya
洲际	intercontinental
活动挂图	flipchart
活化	activation
活塞	piston
活度	activity
活板	trapdoor
活着	alive
流亡政府	government-in-exile
流利	fluent
流感	flu
流星体	meteoroid
流苏	tassels
流萤	firefly
流行性感冒	influenza
流变学	rheology
流量计	flowmeter
流体	fluid
浙赣	Zhejiang-Jiangxi
浣女	washerwoman
浩浩荡荡	majestic
浪子	loafer
浪漫	romantic
浪漫主义	romanticism
浪船	swingboat
浮世绘	ukiyo-e
浮力	buoyancy
浮标	buoy
浮沫	froth
浮浅	skin-deep
浮游生物	plankton
浮肿病	dropsy
浮萍	duckweed
浮着	afloat
浮点数	float
浴缸	bathtub
浴血	blood-soaked
浴袍	bathrobe
海上	maritime
海员	sailor
海啸	tsunami
海地	Haiti
海外	overseas
海宝	Haibao
海岬	headland
海岱	Haidai
海岸警卫队	coastguard
海峡	strait
海带	kelp
海底	seabed
海底轮	muladhara
海德堡	Heidelberg
海水	seawater
海洋学	oceanography
海洋性贫血	thalassemia
海淀区	Haidian
海尔德兰	Gelderland
海牛	manatee
海狸鼠	nutria
海盗	pirate
海盗行为	piracy
海绵状	spongy
海苔	nori
海草	seagrass
海虹	mussel
海豚	dolphin
海豚馆	dolphinarium
海象	walrus
海豹科	Phocidae
海军	navy
海迪	Heidi
海鲜	seafood
海鸟	seabird
海鸥	gull
浸信会	Baptists
消化不良	indigestion
消毒剂	disinfectant
消消停停	intermittently
消费级	consumer-grade
消费者	consumer
消防员	firefighter
消防队员	fireman
消音器	silencer
涉黑	gang-related
涎沫	spittle
液滴	droplet
液胞	vacuole
液体	liquid
涵洞	culvert
涵淡	waves
涷	rainstorm
凉鞋	sandal
淋巴液	lymph
淋巴瘤	lymphoma
淋巴细胞	lymphocyte
凄清	somber
泪	teardrops
泪滴	teardrop
淡光	shimmer
淤伤	bruising
淫乱	promiscuous
淫欲	lust
淫棍	womanizer
淫秽	obscene
深渊	abyss
深谋	forethought
渊冲	insightful
混乱	confused
混凝剂	coagulant
混合物	mixture
混合现实	MR
混血	mixed-race
浅析	primary
浅浮雕	bas-relief
浅薄	superficial
清教徒	Puritan
清晰	clear
清洁器	cleaner
清澄	limpid
清盘	liquidation
清真寺	mosque
减法	subtraction
减震器	shock-absorber
渠魁	ringleader
渤海	Parhae
渥太华	Ottawa
涡扇	turbofan
涡桨	turboprop
涡轮喷气发动机	turbojet
涡轮轴发动机	turboshaft
测谎仪	polygraph
游戏手柄	gamepad
游泳馆	natatorium
湄	coast
湍流	turbulence
湖	lake
湖沼学	limnology
湖边	lakeside
湘黔	Hunan-Guizhou
湫	marsh
汤加里罗	Tongariro
汤汁	soup
准妈妈	mother-to-be
准决赛	semifinal
准确性	accuracy
准谱儿	certainty
沟谷	gully
沟道	groove
溢满	overflowing
溥仪	Puyi
溪流	stream
温和	lukewarm
温和性	tenderness
温室	greenhouse
温尼伯	Winnipeg
温度表	thermometer
温得和克	Windhoek
温文	genteel
温暖	warm
温温	mild
温特图尔	Winterthur
温跃层	thermocline
温雅	gentle
溶剂	solvent
溶质	solute
溶酶体	lysosome
溶体	solution
滂臭	smelly
灭虫宁	bephenium
滑板	skateboard
滑沙	sandboarding
滑石	talc
滑翔机	glider
滑膛	smoothbore
滑雪索道	ski-lift
滑雪运动	skiing
滑音	glissando
滔滔	torrential
滞	stagnant
渗人	horrifying
渗出物	exudate
渗析	dialysis
渗滤	percolation
渗碳	carburization
渗色	bleeding
滴下	drip
滴定	titration
滴定管	burette
滴流	trickle
满手	handful
满洲	Manchuria
满洲国	Manchukuo
满身尘埃	dusty
渔夫	fisherman
渔妇	fisherwoman
漂亮	pretty
漂白剂	bleach
漂游	drift
漆器	lacquerware
漆黑	pitch-black
溇	drizzle
漏斗	funnel
演出者	performer
演员	actor
演员阵容	troupe
演习	exercise
演讲家	orator
漜	mud
汉英	Chinese-English
汉诺威	Hanover
涟漪	ripple
漱口水	mouthwash
渐冻症	ALS
渐渐	gradually
浆果	berry
泼掉	spill
洁	clean
洁食	kosher
潘多拉	Pandora
潜望镜	periscope
潜水器	submersible
潜艇	submarine
潟湖	lagoon
润滑剂	lubricant
润肤霜	moisturizer
潭腿	Tantui
潮人	trendsetter
潮汐	tide
潮男	metrosexual
潮红	flush
潮解性	deliquescent
潸	tearfully
涝	flooded
澡	bath
泽兰	Eupatorium
淀粉	starch
淀粉酶	amylase
澳	cove
澳大利亚	Australia
澳洲小鹦鹉	lorikeet
澳际	Aoji
激光	laser
激光雷达	lidar
激励机制	incentives
激素	hormone
激进主义	radicalism
激进分子	radical
浊度	turbidity
浓缩咖啡	espresso
濊貊	Yemaek
湿地	wetland
湿润	moist
湿疹	eczema
湿衣	wetsuit
湿黏	clammy
泞	muddy
滨江	riverside
溅射	sputtering
溅开	splash
滤液	filtrate
泻药	laxative
瀑布	waterfall
瀛	ocean
瀛洲	Yingzhou
瀡	slippery
洒水机	sprinkler
滩涂	mudflat
滩头	beach
火山	volcano
火山学	volcanology
火影忍者	Naruto
火成碎屑	pyroclastic
火星	spark
火星人	Martian
火烈鸟	flamingo
火球	fireball
火眼	pinkeye
火葬场	crematorium
火药	gunpowder
火轮船	steamboat
火鸡	turkey
火麻	hemp
灰尘	dust
灰度	grayscale
灰烬	ashes
灰猎犬	greyhound
灰白	ash-colored
灶台	stovetop
灶神	Zaoshen
灶神星	Vesta
灼急	worried
灼热	scorching
灾难	disaster
灾难性	catastrophic
炎症	inflammation
炭焙	charcoal-roasted
炭疽热	anthrax
炮舰	gunship
炯炯	shining
炳著	eminent
炴	firelight
炸锅	fryer
炸雷	thunderclap
为了	for
为何	why
烈度	intensity
烈日	Liege
乌克兰	Ukraine
乌干达	Uganda
乌拉圭	Uruguay
乌日	Wuri
乌普萨拉	Uppsala
乌有	nonexistent
乌木	ebony
乌尔根奇	Urgench
乌兹别克斯坦	Uzbekistan
乌里雅苏台	Uliastai
乌鲁鲁	Uluru
乌龙面	udon
烘焙师	baker
烘焙店	bakery
烤箱	oven
烤饼	scone
烤面包机	toaster
烯	alkene
烃	hydrocarbon
烃化作用	alkylation
烷	alkane
烷基	alkyl
烹调术	cookery
烹饪	cooking
焓	enthalpy
无上	supreme
无人机	drone
无休无止	ceaseless
无偿	free
无两	unparalleled
无原则	unprincipled
无可	can't
无可争议	undeniable
无名之辈	nobody
无害	harmless
无底	bottomless
无微不至	meticulous
无思无虑	untroubled
无所不包	all-encompassing
无所不在	omnipresent
无所不知	omniscient
无所不能	omnipotent
无把握	uncertain
无政府主义	anarchism
无条件	unconditional
无止尽	endless
无毛	hairless
无法无天	lawless
无烟煤	anthracite
无瑕	faultless
无生命	non-living
无产阶级	proletariat
无疑	undoubtedly
无症状	asymptomatic
无痕	traceless
无痛	painless
无知觉	senseless
无神论	atheism
无神论者	atheist
无秩序	disorder
无稽	nonsense
无穷无尽	boundless
无纸化	paperless
无丝分裂	amitosis
无线	wireless
无线网络	Wi-Fi
无缝	seamless
无翅	wingless
无脊椎动物	invertebrate
无脑	brainless
无与伦比	incomparable
无色	colorless
无菌	sterile
无菌性	aseptic
无处	nowhere
无论何人	whoever
无论何时	whenever
无趣	dull
无足轻重	insignificant
无轨	trackless
无轨电车	trolleybus
无连接	connectionless
无边无际	limitless
无关痛痒	irrelevant
无限期	indefinitely
无障碍	barrier-free
无题	untitled
无麸质	gluten-free
焦油	tar
焦糖	caramel
焦点	focus
焰	flame
然后	then
然而	however
煁	brazier
炼狱	purgatory
炼金术	alchemy
炼金术士	alchemist
烟囱	chimney
烟民	smokers
烟气	smoke
烟火	fireworks
烟灰缸	ashtray
烟草	tobacco
煤油	kerosene
煤渣	slack
煤炭	coal
煤砖	briquette
焕	glowing
照明弹	flare
烦心	annoying
烦心事	troubles
烦闷	moody
煽动性	provocative
熊孩子	brat
熏香	incense
荧光	fluorescence
熔浆	lava
熔矿炉	furnace
熔解	fusion
熙提	stilb
熟思	deliberation
熟练工	journeyman
熟门熟路	familiar
熟食店	deli
热切	fervent
热力	heat
热力学	thermodynamics
热射病	heatstroke
热心	enthusiastic
热心肠	warmhearted
热核	thermonuclear
热潮	craze
热词	buzzword
热轧	hot-rolling
热那亚	Genoa
热释光	thermoluminescence
热电	pyroelectric
热电偶	thermocouple
燃料	fuel
灯心	lampwick
灯柱	lamppost
灯火	lights
灯笼	lantern
灯台	lampstand
炖饭	risotto
烧水壶	kettle
烧脑	brain-bending
烧鸟	yakitori
燕子	swallow
燕麦	oats
营地	camp
营寨	barracks
营业收入	revenue
营火	campfire
营养学	nutriology
营养物质	nutrient
燧人	Suiren
燧人氏	Suirenshi
燧发枪	flintlock
燹	conflagration
熏肉	bacon
熏蒸剂	fumigant
爆弹	bomb
爆破手	dynamiter
爆竹	firecracker
爆裂物	explosives
炉灶	stove
炉边	fireside
烂人	lowlife
烂俗	clichéd
烂崽	low-life
烂摊子	shambles
爬犁	sledge
爬行动物	reptile
争论点	contention
争议性	controversial
父权制	patriarchy
父母	parents
父老	elders
爹	dad
爷爷	grandpa
爽歪了	amazing
尔来	lately
墙壁	wall
片语	phrase
片头	intro
版式	format
版权	copyright
牌号	trademark
牍	documents
牙痛	toothache
牙科	dentistry
牙签	toothpick
牙结石	tartar
牙买加	Jamaica
牙医	dentist
牙龈炎	gingivitis
牛仔	cowboy
牛仔布	denim
牛奶糖	toffee
牛排	steak
牛排馆	steakhouse
牛犊	calf
牛痘	cowpox
牛皮癣	psoriasis
牛磺酸	taurine
牛肉	beef
牛蛙	bullfrog
牛角面包	croissant
牛头	Ox-Head
牛饮	gulp
牛魔王	Gyuumao
牛黄	bezoar
牡蛎	oyster
牢狱之灾	imprisonment
牧民	herdsman
牧神节	Lupercalia
牧羊人	shepherd
牧羊犬	sheepdog
物主	owner
物候学	phenology
物品	articles
物物交换	barter
物理	physics
物理学家	physicist
物种	species
牲畜	livestock
牳	bovine
牸牛	cow
特伦顿	Trenton
特内里费	Tenerife
特定	special
特技演员	stuntman
特技跳伞	skydiving
特拉法尔加	Trafalgar
特拉华	Delaware
特此	hereby
特发性	idiopathic
特立尼达	Trinidad
特罗多斯	Troodos
特艺彩色	Technicolor
特制	custom-made
犀牛	rhinoceros
犀鸟	hornbill
犁	plow
犁沟	furrow
犁铧	plowshare
犄角	horn
犉	ox
犍牛	bullock
犬儒	cynic
犬儒主义	cynicism
犬夜叉	Inuyasha
犬戎	Quanrong
犬舍	kennel
犯罪学	criminology
犰狳	armadillo
狂乱	hysterical
狂人	madman
狂怒	furious
狂悖	outrageous
狂欢节	carnival
狂犬病	rabies
狄俄倪索斯	Dionysus
狆	Pekingese
狐	fox
狐猴	lemur
狐獴	meerkat
狒狒	baboon
狗仔队	paparazzi
狗屁不通	nonsensical
狗东西	scumbag
狗狗	doggie
狗窝	doghouse
狗腿	lackey
狘	jump
狡猾	crafty
狭窄	narrow
狭谷	glen
狼人	werewolf
狼狗	wolfdog
猖	ferocious
猗	interj.
猛烈	fierce
猝	abruptly
猝睡症	narcolepsy
猞猁	lynx
猢狲	macaque
猩红	scarlet
猴儿	monkey
猴猴族	Qauqaut
猴痘	monkeypox
犹他	Utah
犹太人	Jew
犹太复国主义	Zionism
犹太教	Judaism
犹太教堂	synagogue
犹如	like
犹达	Jude
猸子	mongoose
猾	sly
猿	ape
猿人	apeman
狮虎兽	liger
狮身人面像	sphinx
奖赏	reward
獚	spaniel
獠牙	tusk
獢	dog
独一无二	unmatched
独奏	solo
独家	exclusive
独居石	monazite
独特	unique
独眼巨人	cyclops
独自	alone
独行侠	loner
独角兽	unicorn
獬豸	Xiezhi
狞猫	caracal
获胜者	victor
获得者	recipient
获奖者	prizewinner
猎	hunting
猎人	hunter
猎物	prey
猎犬	hound
猎豹	cheetah
猎鹰	falcon
兽奸	bestiality
兽疫	epizootic
兽装	fursuit
兽类	animals
獾	badger
玄孙	great-great-grandson
玄幻	xuanhuan
玄虚	arcane
玄关	vestibule
率	rate
玉	jade
玉泉营	Yuquanying
玉米花	popcorn
玉米赤霉烯酮	zearalenone
玉米面	cornmeal
玉素甫	Yusuf
玉蜀黍	corn
玉衡	Alioth
王八蛋	bastard
王冠	crown
王家	princely
王府井	Wangfujing
王朝	dynasty
玓	pearly
玢	porphyrites
玩伴	playmate
玩物	toy
玫瑰花	rose
玻利维亚	Bolivia
玻璃化	vitrification
玻璃纸	cellophane
玻璃纤维	fiberglass
珉	alabaster
珊瑚	coral
珍多冰	cendol
珍珠岩	perlite
珍贵	precious
珞	neck-ornament
珞巴语	Lhoba
珠母	mother-of-pearl
班伯利	Bunbury
班图斯坦	Bantustan
班房	jail
现代	Hyundai
现代性	modernity
现在	now
现实主义	realism
现时	current
现象学	phenomenology
现象级	phenomenal
现金	cash
球孢子菌病	Coccidioidomycosis
球形	spherical
球蛋白	globulin
球体	spheroid
理事会	council
理光	Ricoh
理学	science
理工男	geek
理性主义	rationalism
理想主义	idealism
理疗	physiotherapy
理疗师	physiotherapist
理发师	barber
琥珀	amber
琴鸟	lyrebird
琵琶	pipa
珐琅	enamel
瑀	chalcedony
瑙鲁	Nauru
瑞典	Sweden
瑞典人	Swede
瑞士	Switzerland
琐事	trifle
琐细	trivial
琐罗亚斯德	Zoroaster
琐罗亚斯德教	Zoroastrianism
玛拉基亚	Malachi
玛瑙贝	cowrie
玛莎拉蒂	Maserati
环保主义	environmentalism
环保主义者	environmentalist
环烷烃	cycloalkane
环礁	atoll
环节动物门	Annelidan
瓖	ornaments
瓜德罗普	Guadeloupe
瓜达拉哈拉	Guadalajara
瓜达尔	Gwadar
瓜达尔卡纳尔岛	Guadalcanal
瓠	gourd
瓦加杜古	Ouagadougou
瓦器	pottery
瓦尔特	Walter
瓦当	eaves-tile
瓦西里	Vasiliy
瓦隆	Walloon
瓶塞钻	corkscrew
瓶胚	preform
瓶装	bottled
甘味剂	sweetener
甘托克	Gantok
甘油三酯	triglyceride
甘纳豆	amanattō
甘菊	chamomile
甘蔗渣	bagasse
甘愿	willingly
甚平	jinbei
甚至	even
甚巨	considerable
甜	sweet
甜味	sweetness
甜品	dessert
甜瓜	muskmelon
甜甜圈	doughnut
甜菊糖苷	stevioside
生分	estranged
生动	lively
生化需氧量	BOD
生命力	vitality
生命线	lifeline
生态友好型	eco-friendly
生态圈	ecosphere
生态学	ecology
生态学家	ecologist
生态旅游	ecotourism
生态系统	ecosystem
生有权	birthright
生殖轮	svadhisthana
生煎	shengjian
生物传感器	biosensor
生物力学	biomechanics
生物化学	biochemistry
生物化学家	biochemist
生物反应器	bioreactor
生物圈	biosphere
生物多样性	biodiversity
生物学	biology
生物学家	biologist
生物专一性	biospecificity
生物性	biological
生物恐怖主义	bioterrorism
生物晶片	biochip
生物材料	bio-materials
生物柴油	biodiesel
生物气体	bio-gas
生物活化性	bioactivity
生物测定	bioassay
生物燃料	biofuel
生物群	biota
生物能	bio-energy
生物降解	biodegradation
生物高分子	biopolymers
生物碱	alkaloid
生理学	physiology
生理学家	physiologist
生理性	physiological
生产企业	manufacturer
生苔	mossy
生辰	birthday
生鱼片	sashimi
产后	postnatal
产量	output
用度	expense
用户名	username
用法	usage
甪端	Luduan
田亩	field
田纳西	Tennessee
田鼠	vole
由来	origin
甲壳虫	beetle
甲壳类	crustacean
申请人	applicant
男中音	baritone
男女同校	coeducation
男孩子	boy
男巫	wizard
男性主义	masculism
男朋友	boyfriend
男爵	baron
界限	boundary
畔	edge
畔援	domineering
留兰香	spearmint
留言本	guestbook
畚斗	dustpan
毕加索	Picasso
毕业生	graduate
毕达哥拉斯	Pythagoras
略微	slightly
略称	abbreviation
番木瓜	papaya
画作	painting
画架	easel
画质	resolution
异丁烷	isobutane
异性恋主义	heterosexism
异戊二烯	isoprene
异步	asynchronous
异装癖	transvestism
异见者	dissident
异议	objection
当地	local
当局	authorities
当头	surety
畸型	malformation
叠层岩	stromatolite
疏勒国	Shule
疐	prostrate
疑念	doubt
疑惧	misgivings
疝气	hernia
疣猪	warthog
疤痕	scar
疥	scabies
疫苗	vaccine
疲	weary
疳	rickets
疽	gangrene
疾病	disease
痂	scab
病厌厌	sickly-looking
病榻	sickbed
病毒	virus
病毒性	viral
病毒血症	viremia
病理学	pathology
病理学家	pathologist
症状性	symptomatic
痔疮	hemorrhoid
痘痘	pimple
痉	spasm
痛经	dysmenorrhea
痛风	gout
痢疾	dysentery
痭	menorrhagia
痯	ill-looking
痰盂	spittoon
痰盂式	spittoon-shaped
痴呆症	dementia
痼癖	addiction
痿	atrophy
瘃	chilblain
瘊	wart
疯狂	crazy
瘟疫	plague
疮疡	sore
瘦削	slim
瘦骨伶仃	scrawny
瘦骨嶙峋	skinny
疟疾	malaria
瘭	whitlow
瘆人	scary
瘰螈	triton
瘘管	fistula
疗法	therapy
疗养院	sanatorium
癌	cancer
瘪陷	deflated
痴情	infatuation
癞蛤蟆	toad
痈	carbuncle
瘫	paralyzed
癫痫	epilepsy
登山家	mountaineer
登山扣	carabiner
登记员	registrar
发明家	inventor
发棵	budding
发声法	intonation
发薪日	payday
发言人	spokesperson
发送器	transmitter
发电量	capacity
白人	Caucasian
白俄罗斯	Belarus
白化病	albinism
白名单	whitelist
白喉	diphtheria
白垩	chalk
白报纸	newsprint
白左	naive
白带	leukorrhea
白厅	Whitehall
白榴石	leucite
白沙瓦	Peshawar
白烂	ridiculous
白癜风	vitiligo
白色体	leucoplast
白萝卜	daikon
白血病	leukemia
白银	silver
白钨矿	scheelite
白雪	snow
白云石	dolomite
白骨顶	coot
白鱼	whitefish
白面儿	heroin
百事可乐	Pepsi
百兆	100Base-T
百分之	percent
百分比	percentage
百合	lily
百合子	Yuriko
百度	Baidu
百慕大	Bermuda
百岁老人	centenarian
百草枯	paraquat
百万	million
百万富翁	millionaire
百变	ever-changing
百越	Baiyue
百灵鸟	skylark
皂石	soapstone
的里雅斯特	Trieste
皇后区	Queens
皇后镇	Queenstown
皇子	prince
皭	pure
皮匠	cobbler
皮层	cortex
皮层性	cortical
皮星	picosatellite
皮条客	pimp
皮钦语	pidgin
皮炎	dermatitis
皮尔	Pierre
皮秒	picosecond
皮肤病	dermatosis
皮肤科	dermatology
皮艇	kayak
皮货	furs
皮质醇	cortisol
皮质类固醇	corticosteroid
皮鞋匠	shoemaker
皮鞭	lash
益生菌	probiotics
盎格鲁	Anglo-
盎格鲁萨克逊	Anglo-Saxon
盛宴	feast
盛怒	enraged
盛行率	prevalence
盗贼	robber
盟友	ally
监狱	prison
监督人	superintendent
监督者	supervisor
监视孔	peephole
监护人	guardian
盘膝	cross-legged
盥洗盆	washbowl
盦	container
卢旺达	Rwanda
卢森堡	Luxembourg
目击者	eyewitness
目珠	eyeball
目录学	bibliography
目镜	eyepiece
盲	blind
盲字	braille
盲肠炎	appendicitis
直到	until
直勾勾	staring
直升机坪	helipad
直布罗陀	Gibraltar
直径	diameter
直截	straightforward
直方图	histogram
直觉	intuition
直觉性	intuitiveness
直隶	Zhili
相互关系	interrelationship
相似	similar
相向	face-to-face
相对比较	relatively
相思病	lovesickness
相关性	correlation
省份	province
眉头	brows
看不习惯	unfamiliar
看守者	watchman
真主	Allah
真如	Tathata
真实	true
真心	wholeheartedness
真核	eukaryotic
真格的	real
真皮层	dermis
真确	authentic
真诚	sincere
真髓	essence
眨眼睛	wink
眹	pupil
眼光短	short-sighted
眼界	scope
眼皮	eyelid
眼眸	eyes
眼睫毛	eyelashes
眼科学	ophthalmology
眼科医生	ophthalmologist
眼角膜	cornea
眼镜蛇	cobra
众创空间	hackerspace
众多	numerous
众筹	crowdfunding
𪾢	goggle-eyed
困意	sleepiness
睛	eye
睡眠者	sleeper
睡眠虫	trypanosome
睡衣裤	pajamas
睡袍	nightgown
睡鼠	dormouse
睫毛膏	mascara
睾丸	testicle
睾丸素	testosterone
瞑眩	dizziness
瞪羚	gazelle
瞬时	instantaneous
瞬间转移	teleportation
蒙蒙黑	dusk
矛柄	shaft
矟	lance
知乎	Zhihu
知名	well-known
知恩不报	ungrateful
知识分子	intellectual
知识论	epistemology
矧	interrog.
短吻鳄	alligator
短文	article
短歌	ballad
短缺	shortage
短袜	sock
矮人	dwarf
矮黑人	Negrito
石匠	stonemason
石南属	heather
石南树	heath
石墨烯	graphene
石景山区	Shijingshan
石棉	asbestos
石棺	sarcophagus
石榴	pomegranate
石河子	Shihezi
石油化学	petrochemistry
石灰岩	limestone
石磨	grindstone
石笋	stalagmite
石脑油	naphtha
石英	quartz
石质	stony
矻矻	assiduously
矽肺病	silicosis
矽藻	diatom
矽铝层	Sial
砂子	sand
砂岩	sandstone
砂砾	grit
砌砖工	bricklaying
砌路	paving
砌体	brickwork
砍刀	machete
研究员	researcher
研华	Advantech
研讨	discussion
炮艇	gunboat
破坏性	destructive
破坏活动	sabotage
破布	rag
破缺	breaking
破旧	shabby
硅藻门	Bacillariophyta
硅酮	silicone
硅酸盐	silicate
硐	grind
硝化甘油	nitroglycerine
硝酸盐	nitrate
硫氰酸酶	rhodanase
硫氰酸盐	thiocyanate
硫胺素	thiamine
硫酸盐	sulfate
硫黄	sulfur
硬件	hardware
硬度	hardness
硬拉	deadlift
硬木	hardwood
硬壳	crust
硬玉	jadeite
硬编码	hard-coded
砚	ink-stone
硼砂	borax
碎块	fragment
碎布条	shred
碎片	chip
碎石	gravel
碎肉	mincemeat
碏	gems
碗柜	cupboard
碧玉	jasper
碳化物	carbide
碳水化合物	carbohydrate
砜	sulfone
确定性	determinacy
码率	bitrate
码头	wharf
碾槌	pestle
碾盘	millstone
磁气圈	magnetosphere
磁轨炮	railgun
磁铁	magnet
砖头	brick
磨坊	mill
磨坊主	miller
磨砂机	sander
磷光	phosphorescence
磷脂	phospholipid
磷虾	krill
磷酸盐	phosphate
礁石	reef
硚头	Qiaotou
矿山	mine
矿工	miner
矿物学	mineralogy
矿物质	mineral
矿产	minerals
矿石	ore
矿盐	halite
示威运动	rally
示性	expressivity
礽	blessings
社会主义	socialism
社会主义者	socialist
社会名流	celebrity
社会学	sociology
社会性	social
社会环境	milieu
社会经济	socio-economic
社会语言学	sociolinguistics
祉	felicity
祖国	motherland
祖母绿	emerald
祖鲁	Zulu
祝融	Zhurong
神奈川	Kanagawa
神学家	theologian
神学院	seminary
神性	divinity
神憎鬼厌	loathsome
神户	Kobe
神枪手	sharpshooter
神权统治	theocracy
神殿	shrine
神汉	sorcerer
神秘主义	mysticism
神经元	neuron
神经外科	neurosurgery
神经学	neurology
神经学家	neurologist
神经官能症	neurosis
神经毒素	neurotoxin
神经生物学	neurobiology
神经衰弱	neurasthenia
神话故事	myth
神谕	oracle
神道教	Shinto
票价	fare
祭司	priest
祭司权术	priestcraft
祭坛	altar
祭物	sacrifices
禄蠹	sinecurist
禁夜	curfew
禁欲主义	asceticism
福佬	Hoklo
福音书	gospel
礼拜仪式	liturgical
礼拜六	Saturday
礼节	etiquette
礼宾员	concierge
禽龙	iguanodon
秀色孙鲽	yellowtail
私办	privately-run
秋海棠	begonia
秋叶原	Akihabara
科克	Cork
科威特	Kuwait
科学主义	scientism
科摩洛	Comoros
科浦	Coop
科尔多瓦	Córdoba
科系	department
科索沃	Kosovo
科罗拉多	Colorado
科迪勒拉	Cordillera
科隆水	cologne
秒表	stopwatch
秘书	secretary
秘书长	secretary-general
秘鲁	Peru
租约	lease
租金	rent
秧歌	Yangge
秧苗	seedling
秩序	order
秭	billion
移动式	mobile
移动性	mobility
移植性	portability
移液器	pipette
稀有	uncommon
稀饭	porridge
稀松平常	ordinary
税收	taxation
税费	tax
程序员	programmer
程序性	program
程度	degree
稍快板	allegretto
稛	full
稞	wheat
禀赋	gift
稠密	dense
种子岛	Tanegashima
种族	race
种族中心主义	ethnocentrism
种族主义	racism
种族灭绝	genocide
种植园	plantation
种脐	omphalodium
称心如意	gratifying
称谓	title
稻草人	scarecrow
稽查	inspection
稿件	manuscript
谷仓	barn
谷壳	chaff
谷神星	Ceres
谷饲	grain-fed
穆斯林	Muslim
穆萨维	Moussavi
穆迪	Moody's
穆黑	Islamophobe
积极进取	proactive
积累性	cumulative
积雪场	snowpack
秽	filthy
稳	settled
稳妥	dependable
稳定币	stablecoin
稳定性	stability
空性	emptiness
空想性错视	pareidolia
空手道	karate
空气动力学	aerodynamics
空气流通	ventilation
空空荡荡	deserted
空缺	vacancy
空腔	cavity
空着手	empty-handed
空荡荡	empty
空降兵	paratroopers
穿堂风	draft
穿洞	pierce
穿着	attire
突厥斯坦	Turkestan
突尼斯市	Tunis
突击队员	commando
突然	sudden
突破性	groundbreaking
突触	synapse
突触后	postsynaptic
窗子	window
窗台	windowsill
窘况	predicament
窨井	manhole
窝咑	otak
窝点	lair
洼地	depression
立刻	immediately
立法机关	legislature
立卧撑跳	burpee
立足点	foothold
立陶宛	Lithuania
立体派	Cubism
站姿	stance
站街女	streetwalker
童年	childhood
端到端	end-to-end
端粒	telomere
端粒酶	telomerase
竞争对手	rival
竞争者	competitor
竹编	wickerwork
笑声	laughter
笙	sheng
笛	flute
符文	rune
符号	symbol
第一手	first-hand
第一流	first-class
第三十	thirtieth
第五	fifth
笰	duster
笔刷	paintbrush
笔迹	handwriting
等周	isoperimetric
等效	equivalent
等温	isothermic
等级制度	hierarchy
等距	equidistant
筋脉	veins
筏子	raft
策展人	curator
筷	chopstick
筷子芥	Arabis
箍桶店	coopery
箑	fan
算命先生	fortune-teller
算术	arithmetic
箙	quiver
管取	sure
管弦乐团	orchestra
箭毒木	antiaris
箭镞	arrowhead
箱根	Hakone
节俭	frugal
节奏口技	beatboxing
节庆	festival
节拍器	metronome
节气门	throttle
节疤	gnarl
节肢动物	arthropod
节点	node
范例	example
范儿	manner
范式	paradigm
篇什	poem
篇章	chapter
筑城	fortification
篝火	bonfire
篡贼	usurper
筚	wicker
简单	simple
简直	simply
簧风琴	harmonium
箫	xiao
签字者	signatory
签章	signature
帘子	curtain
簿记	bookkeeping
篮筐	basket
篮网球	netball
筹款	fundraising
笼子	cage
米白色	off-white
米粒组织	granulation
米粥	congee
米纳尔迪	Minardi
米该亚	Micah
米黄	beige
籵	dm
籽	seeds
粉砂岩	siltstone
粉红色	pink
粒细胞	granulocyte
粗劣	coarse
粗暴	crude
粗管面	rigatoni
粗莽	brusque
粘稠	viscous
粱	sorghum
粤海	Guangdong-Hainan
精品店	boutique
精囊	spermatophore
精子	spermatozoon
精工	Seiko
精巧	elaborate
精度	precision
精明	astute
精液	semen
精神分析	psychoanalysis
精神分裂症	schizophrenia
精神病学	psychiatry
精神科医生	psychiatrist
精神错乱	insanity
精算	actuarial
精算师	actuary
精美	exquisite
精髓	marrow
糅	mix
糊精	dextrin
糌粑	tsampa
糍粑	ciba
糕	cake
糖原	glycogen
糖尿病	diabetes
糖浆	syrup
糖精	saccharin
糖脂	glycolipid
糖苷	glucoside
糖萼	glycocalyx
糖蛋白	glycoprotein
糜烂性毒剂	vesicant
粪蛆	muckworm
糢	blurred
系统性	systematic
纠纷	dispute
纪律	discipline
纪念品	souvenir
纪念奖	trophy
纪念碑	monument
约克	York
约定资讯速率	CIR
约沙法	Jehoshaphat
约纳	Jonah
约翰内斯堡	Johannesburg
约翰斯顿	Johnston
红利	bonus
红加仑	redcurrant
红学	"Redology"
红客	"honker"
红宝石	ruby
红玛瑙	cornelian
红脖子	redneck
红肠	saveloy
红霉素	erythromycin
红头菜	beetroot
纳什维尔	Nashville
纳匝肋	Nazareth
纳塔乃耳	Nathaniel
纳尼亚	Narnia
纳瓦萨	Navassa
纳瓦霍	Navajo
纳税人	taxpayer
纳米	nanometer
纳米技术	nanotechnology
纳米比亚	Namibia
纳粹主义	Nazism
纳粹分子	Nazi
纳卫星	nanosatellite
纳豆	nattō
纳鸿	Nahum
纽伦堡	Nuremberg
纽卡素	Newcastle
纽扣	button
纯品	sterling
纯度	purity
纯种	purebred
纯血	pure-blooded
纯血统	pure-blood
纯碱	Na2CO3
纱布	gauze
纱线	yarn
纸张	paper
纸板	cardboard
纸烟	cigarette
纸盒	carton
纸草	papyrus
纸钞	banknote
素来	consistently
素日	usually
素食主义	vegetarianism
素食者	vegetarian
纺织者	weaver
纺锤	spindle
索具装置	rig
索尼	Sony
索引	index
索索	trembling
索道	ropeway
索里亚	Soria
索非亚	Sofia
索马里	Somalia
紫丁香	lilac
紫水晶	amethyst
紫菜包饭	gimbap
紫藤	wisteria
细化管理	micromanagement
细小病毒	parvovirus
细小病毒科	Parvoviridae
细支气管炎	bronchiolitis
细碎	fragments
细节	details
细粉	powder
细胞器	organelle
细胞因子	cytokine
细胞学	cytology
细胞毒	cytotoxin
细胞毒性	cytotoxicity
细胞色素	cytochrome
细胞质	cytoplasm
细长	slender
细颈瓶	jug
绅士	gentleman
𫄟	rough
终端机	terminal
组合论	combinatorics
组块	chunk
组织学	histology
组织者	organizer
组织胞浆菌病	histoplasmosis
组织胺	histamine
结存	balance
结晶学	crystallography
结晶状	crystalline
结核病	tuberculosis
结构主义	structuralism
结结巴巴	stammeringly
结肠镜检查	colonoscopy
结膜炎	conjunctivitis
绝壁	precipice
绝对	absolute
绝经	menopause
绝色	stunning
绦虫	tapeworm
绞刀	reamer
绞盘	capstan
绒布	flannel
绒球	pompon
统一性	unity
统一码	Unicode
统治力	dominance
统统	totally
统计员	statistician
统计学	statistics
丝囊	spinneret
丝带	ribbon
丝柏	cypress
丝状	thread-like
丝状物	filament
丝状病毒	filovirus
丝瓜	luffa
丝米	decimillimeter
绛	purple-red
绢	thin
绑匪	kidnapper
绥靖主义	appeasement
经世	statecraft
经度	longitude
经撞	shock-resistant
经济学家	economist
经济有效	cost-effective
经由	via
经纬仪	theodolite
经验主义	empiricism
综合征	syndrome
综效	synergy
绿宝石	beryl
绿油油	verdant
绿洲	oasis
绿色	green
维也纳	Vienna
维京人	Viking
维和	peacekeeping
维基数据	Wikistats
维基物种	Wikispecies
维基解密	WikiLeaks
维多利亚州	Victoria
维冈	Wigan
维尔纽斯	Vilnius
维生素	vitamin
维管	vascular
维纶	vinylon
维罗纳	Verona
网易	NetEase
网景	Netscape
网架	rack
网民	netizen
网眼	mesh
网站	website
网络欺诈	phishing
网络水军	astroturfers
网络空间	cyberspace
网络语言	netspeak
网飞	Netflix
绰名	nickname
绵羊	sheep
紧张缓和	detente
紧急事件	emergency
紧身	skintight
线上	online
线报	tip-off
线状	linear
线粒体	mitochondrion
线绳	cord
线虫	nematode
缎子	satin
缘饰	fringe
编务	editing
编码器	encoder
编者	editor
编译器	compiler
编辑室	newsroom
缓兵之计	stalling
缓动	sluggish
缅元	kyat
缅因	Maine
纬度	latitude
𦈕	net
縡	matter
县	county
缝衣工人	needleworker
缩微平片	microfiche
纵火犯	arsonist
总和	sum
总是	always
总归	anyhow
总社	headquarters
总站	terminus
总要	nevertheless
繁荣昌盛	thriving
繁茂	luxuriant
繁闹	bustling
织品	textile
织布机	loom
绕口令	tongue-twister
绣球花	hydrangea
绳索	rope
绳结	knot
绘文字	emoji
继兄弟姐妹	step-siblings
继子	stepson
继母	stepmother
继父	stepfather
继父母	step-parents
续作	sequel
缠足	foot-binding
纤毛	cilium
纤维状	fibrous
纤维素	cellulose
纤维肌痛	fibromyalgia
缺嘴	harelip
缺德	mean
缺氧症	anoxia
缺陷	defect
罂粟	poppy
罕	rare
罩子	cover
罩衫	smock
罪人	sinner
罪犯	criminal
罪责	guilt
罭	drag-net
罚则	penalty
罗伯茨	Roberts
罗杰	Roger
罗杰斯	Rogers
罗利	Raleigh
罗姆人	Romani
罗安达	Luanda
罗宋汤	borscht
罗得斯岛	Rhodes
罗托鲁瓦	Rotorua
罗斯托夫	Rostov-on-Don
罗氏	Roche
罗洁爱尔之	Raziel
罗盘	compass
罗索	Roseau
罗缎	ribbed
罗兹	Łódź
罗非鱼	tilapia
罗马	Rome
罗马化	romanization
罗马尼亚	Romania
羊怪	faun
羊毛衫	cardigan
羊皮	sheepskin
羊皮纸	parchment
羊羔	lamb
羊羹	yōkan
羊驼	alpaca
美中	US-China
美中台	US-China-Taiwan
美人	belle
美人鱼	mermaid
美他沙酮	metaxalone
美利坚	America
美国	USA
美国国家航空航天局	NASA
美国资讯交换标准码	ASCII
美国电话电报公司	AT&T
美团点评	Meituan-Dianping
美学	aesthetics
美式	American-style
美德	virtue
美意	goodwill
美拉尼西亚	Melanesia
美日	US-Japan
美沙酮	methadone
美洲虎	jaguar
美滋滋	elated
美甲师	manicurist
美索不达米亚	Mesopotamia
美食家	gourmet
美馔	delicacy
美丽	beautiful
羚	antelope
羞愧	ashamed
羞答答	bashful
群花	blossom
羧甲司坦	carbocysteine
义大利面	pasta
义卖会	bazaar
𫅗	spirit
羽流	plume
羽衣甘蓝	kale
翀	soar
翛	hastiness
翠鸟	kingfisher
翳眼	cataract
翼展	wingspan
翼手龙	pterodactyl
翼装	wingsuit
翼龙	pterosaur
老幺	youngest
老千	swindler
老妈	mother
老妈子	amah
老态龙钟	senile
老抠	penny-pincher
老挝	Laos
老梗	hackneyed
老派	old-fashioned
老糊涂	dotard
老练	seasoned
老花眼	presbyopia
老着脸	shamelessly
老调重弹	unoriginal
老铁	bro
老饕	glutton
老鸹	raven
老鹰	hawk
考古学	archaeology
考古学家	archaeologist
考文垂	Coventry
而是	rather
耏	beard
耐克	Nike
耐力	endurance
耐性	patience
耐洗	wash-resistant
耐用	durable
耐酸	acid-resistant
耐高温	heat-resistant
耐碱	alkali-resistant
耕作	farming
耗子	rat
耳垂	earlobe
耳垢	earwax
耳廓	auricle
耳根子	ear
耳源性	otogenic
耳畔	ears
耳痛	earache
耳石	otolith
耳石症	BPPV
耳罩	earmuffs
耳蜗	cochlea
耳鸣	tinnitus
耶稣	Jesus
耶路撒冷	Jerusalem
耶鲁	Yale
耿耿于怀	brooding
圣徒	saint
圣母	goddess
圣神降临周	Whitsuntide
圣约	covenant
圣职	priesthood
圣药	panacea
圣餐	Eucharist
聚丙烯	polypropylene
聚光灯	spotlight
聚合作用	polymerization
聚合物	polymer
聚氨酯	polyurethane
聚碳酸酯	polycarbonate
聚苯乙烯	polystyrene
聚酯	polyester
聚酰亚胺	polyimide
闻名于世	world-famous
联合国教科文组织	UNESCO
联合会	federation
联合组织	syndicate
联想	Lenovo
联欢会	party
联轴器	coupling
联邦快递	FedEx
联体别墅	townhouse
聪明伶俐	clever
聪颖	smart
声学	acoustics
声明书	statement
声望	reputation
声门	glottis
声类	Shenglei
职位	position
职分	duty
职工	employee
职业化	professionalization
职业素质	professionalism
职涯	career
听得见	audible
听诊器	stethoscope
听说读写	listening
聋	deaf
肇事逃逸	hit-and-run
肉丸	meatball
肉冻	aspic
肉嘟嘟	chubby
肉条	cutlet
肉毒中毒	botulism
肉类	meat
肉食	carnivorous
肉食动物	carnivore
肋骨	rib
肌	muscle
肌动蛋白	actin
肌肉男	muscleman
肌肉发达	muscular
肌酸	creatine
肖恩	Sean
肚痛	stomachache
肚脐眼	navel
肛	rectum
肛门	anus
肝炎	hepatitis
肝硬化	cirrhosis
肝脏	liver
股利	dividend
股骨	femur
肢	limb
肥沃	fertile
肥胖	fat
肥胖症	obesity
肩并肩	abreast
肩膀	shoulder
肫	gizzard
肯塔基	Kentucky
肯尼亚	Kenya
肱骨	humerus
育幼院	orphanage
肺气肿	emphysema
肺脏	lungs
肼	hydrazine
胃下垂	gastroptosis
胃炎	gastritis
胃蛋白酶	pepsin
胄裔	descendants
背包客	backpacker
背包游	backpacking
背叛者	traitor
背骨	spine
胍	guanidine
胎便	meconium
胎盘	placenta
胎记	birthmark
胚珠	ovule
胚胎	embryo
胚胎学	embryology
胚胎发生	embryogenesis
胚芽鞘	coleoptile
胞宫	uterus
胞衣	afterbirth
胡图族	Hutu
胡桃	walnut
胡椒	pepper
胡椒薄荷	peppermint
胡狼	jackal
胡瓜	cucumber
胡萝卜	carrot
胡萝卜素	carotene
胭脂	rouge
胰岛素	insulin
胰腺	pancreas
胰腺炎	pancreatitis
胳膊肘	elbow
胸口	chest
胸廓	thorax
胸牌	badge
胸甲	breastplate
胸腺	thymus
胸膜炎	pleurisy
胸针	brooch
能见度	visibility
脂粉	cosmetics
脂蛋白	lipoprotein
脆脆	crispy
脆骨	gristle
脉息	pulse
脊柱侧弯	scoliosis
脊椎动物	vertebrate
脊椎动物门	Vertebrata
脊椎指压治疗师	chiropractor
脊椎骨	vertebra
脊索动物	chordata
脊索动物门	Chordata
脊肋	ribcage
脊骨	backbone
脊髓灰质炎	poliomyelitis
脊髓炎	myelitis
脖颈	nape
胫骨	tibia
脱垂	prolapse
脱机	offline
脱氧	deoxidation
脱氧核糖	deoxyribose
脱氧核糖核酸	DNA
脱氢	dehydrogenation
脱衣服	undress
脱衣舞	striptease
胀大	swollen
胀起	bulge
脾性	temperament
脾脏	spleen
腈	acrylic
腋窝	armpit
腌货	pickles
肾	kidney
肾上腺素	adrenaline
腐肉	carrion
腓力	Philip
腓尼基	Phoenicia
腔棘鱼	coelacanth
腕足动物	brachiopod
腕表	wristwatch
腕龙	brachiosaurus
脶	fingerprint
脑岛	insula
脑炎	encephalitis
脑膜炎	meningitis
肿瘤	tumor
肿瘤切除术	lumpectomy
腮胡	sideburns
腰肉	loin
腰间	waist
腱子	sinew
腱炎	tendonitis
脚凳	footstool
脚印	footprint
脚手架	scaffolding
脚指甲	toenail
脚架	tripod
脚气病	beriberi
脚腕	ankle
脚趾头	toe
脚蹬	pedal
肠子	intestines
肠支	cecum
肠毒素	enterotoxins
肠炎	enteritis
肠病毒	enterovirus
肠胃炎	gastroenteritis
腹水	hydroperitoneum
腹语	ventriloquism
腹语师	ventriloquist
腺病毒	adenovirus
腺癌	adenocarcinoma
腺苷	adenosine
腺体	gland
腿部	leg
膀胱炎	cystitis
膔	borborygmus
膗	obese
肤	skin
膝	knee
膝盖骨	kneecap
胶原蛋白	collagen
胶合板	plywood
胶木	bakelite
胶水	glue
胶体	colloid
膦	phosphine
膳食	meals
胆囊	gallbladder
胆固醇	cholesterol
胆小如鼠	gutless
胆小鬼	coward
胆红素	bilirubin
胆结石	gallstone
胆绿素	biliverdin
胆颤心惊	panic-stricken
胆魄	boldness
脓	pus
脓毒症	sepsis
脓肿	abscess
臀	buttocks
臆想狂	mythomaniac
臆想症	mythomania
脸基尼	facekini
脸书	Facebook
脸盲	face-blind
脸罩	visor
脸颊	cheek
腊肠	sausage
卧位	berth
卧病	bed-ridden
卧龙岗	Wollongong
临床	clinical
临时保姆	babysitter
自上而下	top-down
自信心	self-confidence
自传	autobiography
自制力	self-control
自助	self-service
自动化技术	automation
自动射线摄影	autoradiography
自动扶梯	escalator
自在	comfortable
自大	arrogant
自底向上	bottom-up
自恋	narcissism
自我催眠	self-hypnotism
自我意识	self-awareness
自我批评	self-criticism
自我防卫	self-defense
自拍照	selfie
自指	self-reference
自淫	masturbation
自然拼读	phonics
自然段	paragraph
自然神论	deism
自由主义	liberalism
自由意志主义	libertarianism
自由放任	laissez-faire
自由派	liberal
自由潜水	freediving
自由素食主义	Freeganism
自由落体	free-fall
自画像	self-portrait
自发	spontaneous
自给	self-reliant
自举	bootstrapping
自适应	adaptive
自闭症	autism
自愿	voluntary
臭烘烘	stinking
臭臭	poo
臭鼬	skunk
致冷剂	refrigerant
致幻剂	hallucinogen
致死性	lethal
致畸	teratogenic
致癌	carcinogenic
致癌物	carcinogen
台中	Taichung
台湾	Taiwan
台盆	washbasin
臼	mortar
舀子	ladle
与此同时	meanwhile
与众不同	distinctive
兴会	brainwave
旧字体	kyujitai
旧爱	ex
舌	tongue
舞者	dancer
舟车劳顿	travel-worn
航图	chart
航天器	spacecraft
航空	aviation
航空器	aircraft
航空术	aeronautics
航空邮件	airmail
航空邮简	aerogram
舭	bilge
舵手	helmsman
舶	ship
船夫	boatman
船桨	oar
船运业	shipping
艉	aft
舰船	warship
艩	tholepin
良心	conscience
艰巨	challenging
色狼	lecher
色目	Semu
色素	pigment
艳红色	crimson
艾略特	Eliot
芋螺毒素	conotoxin
芋头	taro
芝加哥	Chicago
芝士蛋糕	cheesecake
芝麻菜	rocket
芥	mustard
芫花素	genkwanin
芬兰	Finland
芭提雅	Pattaya
芭比	Barbie
芯片	microchip
芯片组	chipset
花不棱登	gaudy
花冠	corolla
花岗岩	granite
花巧	fancy
花朵	flower
花束	bouquet
花椰菜	cauliflower
花火	firework
花粉	pollen
花花公主	playgirl
花花公子	playboy
花萼	sepal
花莲	Hualien
花艺	floriculture
花艺师	florist
花蜜	nectar
芽孢	endospore
苔原	tundra
苔藓	moss
苗	sprout
苗床	seedbed
苛刻	harsh
苛求	demanding
苜	clover
若有所思	thoughtfully
若无其事	nonchalant
若隐若现	indistinct
苦因	affliction
苦杏仁苷	amygdalin
苦菊	endive
苦逼	wretched
苦难	suffering
苦头	sufferings
苯乙烯	Styrene
苯胺	aminobenzene
苯那辛	benactyzine
英俊	handsome
英伟达	NVIDIA
英国	Britain
英式	British-style
英式橄榄球	rugby
英格兰	England
英法	Anglo-French
英汉	English-Chinese
英特尔	Intel
英亩	acre
英雄好汉	heroes
英雄式	heroic
苲草	hornwort
茄	eggplant
茄克衫	jacket
茉莉	jasmine
茉莉菊酯	jasmolin
茛	ranunculus
茜素	alizarin
茨欣瓦利	Tskhinvali
茯苓	tuckahoe
茶匙	teaspoon
茶坊	teahouse
茶碗	teacup
茶碗蒸	chawanmushi
茶缸	mug
茶藨子	currant
茶碱	Theophylline
茸	downy
茸毛	fuzz
草丛	underbrush
草坪	lawn
草场	pastureland
草垫子	palliasse
草寇	bandits
草料	fodder
草甸	meadow
草食	herbivorous
草饲	grass-fed
荆芥	schizonepeta
荒原	wasteland
荒山野岭	wild
荒淫	licentious
荒漠化	desertification
荒谬	absurd
荔	litchi
荵	polemonium
荷官	croupier
荷花	lotus
荷荷巴	jojoba
荷兰	Holland
荷马	Homer
莎草	coco-grass
莫吉托	Mojito
莫名	inexpressible
莫拉莱斯	Morales
莫斯科	Moscow
莫桑比克	Mozambique
莫须有	groundless
莽汉	boor
菁英	elite
菊苣	chicory
菌群	microbiota
菌胶团	zoogloea
菌菇	mushroom
菌类	fungus
菜燕	agar-agar
菜脯	dried
菜肴	dish
菠	spinach
菠萝	pineapple
菠萝蜜	jackfruit
菢	hatch
菥蓂	pennycress
菧	stibene
菩提达摩	Bodhidharma
菪	henbane
华林部	Hualinbu
华氏	Fahrenheit
华沙	Warsaw
华盛顿州	Washington
华丽	gorgeous
菱形	rhombus
菱铁矿	siderite
菲亚特	Fiat
菲律宾人	Filipino
烟酰胺	nicotinamide
烟醯胺	niacinamide
烟碱	nicotine
莱城	Lae
莱斯特郡	Leicestershire
莱比锡	Leipzig
莱索托	Lesotho
萎靡不振	downcast
万事通	jack-of-all-trades
万事达	MasterCard
万亿	trillion
万分痛苦	excruciating
万托林	ventolin
万无一失	surefire
万用表	multimeter
万科	Vanke
万圣节前夜	Halloween
万艾可	Viagra
万花筒	kaleidoscope
万里无云	cloudless
莴笋	celtuce
落寞	lonely
落拓不羁	uninhibited
落叶剂	defoliant
叶绿素	chlorophyll
叶绿体	chloroplast
叶轮机械	turbomachine
叶里温	Yerevan
著称于世	world-renowned
葛兰素史克	GlaxoSmithKline
葡式	Portuguese-style
葡萄	grape
葡萄干儿	raisin
葡萄园	vineyard
葡萄弹	grapeshot
葡萄树	grapevine
葡萄牙	Portugal
葡萄球菌	staphylococcus
葫芦丝	hulusi
葵花	sunflower
荤粥	Xunyu
蒂森克虏伯	ThyssenKrupp
蒎	pinane
蒙古	Mongolia
蒙古人	Mongol
蒙大拿	Montana
蒙特利尔	Montreal
蒙特维多	Montevideo
蒙特雷	Monterey
蒙罗维亚	Monrovia
蒟蒻	konjac
蒢	hedysarum
蒸汽	steam
蒸粗麦粉	couscous
蒸锅	steamer
蒸腾作用	transpiration
苍天	firmament
苍蝇拍	flyswatter
蒽	anthracene
盖世太保	Gestapo
盖然性	probability
盖茨比	Gatsby
蓬勃	vigorous
蓬头散发	disheveled
蓬松	fluffy
莲蓬头	showerhead
蔙	herb
蔚蓝	azure
葱头	onion
蔬	vegetables
荫	shade
蔾	chenopodiaceae
蕉	banana
荞麦	buckwheat
芸苔子	rapeseed
蕗	leucacene
蕨类	bracken
荡妇	slut
荡荡	fluttering
芜繁	convoluted
蕾	bud
薄烤饼	pancake
薉	weedy
姜	ginger
姜饼	gingerbread
姜黄	turmeric
蔷薇花蕾	rosebud
荐椎	sacrum
萨克逊	Saxon
萨博	Saab
萨拉戈萨	Zaragoza
萨拉曼卡	Salamanca
萨拉热窝	Sarajevo
萨摩	Satsuma
萨摩亚	Samoa
萨满教	Shamanism
萨尔	Saarland
萨尔布吕肯	Saarbrücken
萨尔茨堡	Salzburg
萨兰斯克	Saransk
萨赫蛋糕	Sachertorte
薪资	salary
苔草	sedge
藄	fern
借此	thereby
蓝图	blueprint
蓝宝石	sapphire
蓝牙	Bluetooth
蓝莓	blueberry
蓝金黄	blue
藏书票	bookplate
藘	madder
藜麦	quinoa
艺术	art
藤条	rattan
药代动力学	pharmacokinetics
药典	pharmacopoeia
药剂师	pharmacist
药商	druggist
药妆	cosmeceuticals
药妆店	drugstore
药店	pharmacy
药方	prescription
药物学家	pharmacologist
药理学	pharmacology
药膏	ointment
藻类	algae
芦笋	asparagus
芦荻	reeds
芦苇	reed
苏丹	Sudan
苏克雷	Sucre
苏台德地区	Sudetenland
苏姆盖特	Sumgayit
苏打饼干	saltine
苏格兰	Scotland
苏格兰女王玛丽	Mary
苏格兰帽	bonnet
苏瓦	Suva
苏里南	Suriname
苏金达	Sukinda
苏门答腊	Sumatra
苏黎世	Zurich
苹果手机	iPhone
苹果酒	cider
兰科	Orchidaceae
兰蔻	Lancôme
兰辛	Lansing
兰开斯特	Lancaster
虎皮鹦鹉	budgerigar
虎钳	vise
虎鲸	orca
虐心	heartbreaking
虔敬	reverent
处女膜	hymen
处所	place
处理器	processor
虚妄	fabricated
虚荣	vanity
虚构小说	fiction
虚无	nothingness
虚无主义	nihilism
虚无缥缈	illusory
虱	louse
虸蚄	armyworm
虹	rainbow
虹吸管	siphon
虹桥	Hongqiao
蚊子	mosquito
蚌壳	clamshell
蚔	green-frog
蚜	aphis
蚱蜢	grasshopper
蚺	boa
蛆	maggot
蛇毒素	venin
蛇蝎	treacherous
蛉	sandfly
蛋包	omelet
蛋包饭	omurice
蛋奶酥	soufflé
蛋壳	eggshell
蛋白光	opalescence
蛋白石	opal
蛋白质	protein
蛋白酶	protease
蛋酒	eggnog
蛋黄酱	mayonnaise
蛔虫病	ascariasis
蛙人	frogman
蛙鞋	flippers
蛛网	cobweb
蛤蜊	clam
蛤蟆	frog
蛭石	vermiculite
蛾子	moth
蜂巢	honeycomb
蜂箱	beehive
蜂胶	propolis
蜂蜜酒	mead
蜂蜡	beeswax
蜂鸟	hummingbird
蜂鸣器	buzzer
蜃景	mirage
蜇	jellyfish
蜈蚣	centipede
蜉蝣	mayfly
蜑家	Tanka
蜘蛛	spider
蜘蛛侠	Spider-Man
蜘蛛类	arachnid
蜙蝑	katydid
蜚	gad-fly
蜚蠊科	Blattidae
蜜月	honeymoon
蜜露	honeydew
蜥形纲	Sauropsida
蜥蜴	lizard
蜻蛉目	Odonata
蜻蜓	dragonfly
蝗虫	locust
蝙蝠侠	Batman
虾子	shrimp
蜗蜒	snail
融资	financing
蚂蟥	leech
蚂蚁	ant
萤光绿	chartreuse
螯	chela
螯肢	chelicera
螺刀	screwdriver
螺旋形	spiral
螺旋桨	propeller
螺旋测微器	micrometer
螺旋钳	wrench
螨	mite
蟑螂	cockroach
𫊸	insect
蟥	horse-leech
蝉科	Cicadidae
蛲虫病	enterobiasis
虫胶	shellac
虫类	insects
蟷	mantis
蟹	crab
蟺	earthworm
蚁丘	anthill
蝇子	housefly
蝎子	scorpion
蝾螈	salamander
蠕动前进	wriggle
蠕虫	worm
𧏖	pearl-oyster
蠛蠓	midge
蜡像	waxwork
蜡像馆	waxworks
蜡笔	crayon
蜡质	waxiness
蠡	calabash
蠢事	folly
蠢材	idiot
蚕	silkworm
蚕农	sericulturist
蠼螋	earwig
血刃	bloodshed
血友病	hemophilia
血吸虫	schistosoma
血吸虫病	schistosomiasis
血尿	hematuria
血帮	Bloods
血栓病	thrombosis
血汗工厂	sweatshop
血液透析	hemodialysis
血渍	bloodstain
血红蛋白	hemoglobin
血缘	bloodline
血肉	flesh
血肉模糊	gruesome
血色素沉积症	hemochromatosis
血迹斑斑	bloodstained
行人径	footway
行凶者	perpetrator
行动主义	activism
行家	connoisseur
行政员	administrator
行星际	interplanetary
行业	trade
行为主义	behaviorism
行车记录仪	dashcam
行道	path
术前	preoperative
术后	postoperative
街景	streetscape
街灯	streetlight
街头	street
街头艺人	busker
衙门	yamen
卫理公会	Methodists
卫生棉条	tampon
卫生球	mothball
卫衣	sweatshirt
冲浪者	surfer
衣兜	pocket
衣冠冢	cenotaph
衣原菌	Chlamydia
衣子	covering
衣帽间	cloakroom
衣服缝边	hem
衣橱	wardrobe
衣着	clothes
衣装	garment
表位	epitope
表土	topsoil
表带	watchband
表现型	phenotype
表皮剥脱素	exotoxin
表观	apparent
表观遗传学	epigenetics
表语	predicative
表面上	outwardly
表面活化剂	surfactant
袋子	bag
袋鼠	kangaroo
袖口	cuff
袖子	sleeve
被乘数	multiplicand
被加数	augend
被动	passive
被物化	objectified
被译	translated
被面	quilt
裁判员	referee
裁定	ruling
裁缝师	tailor
裁军	disarmament
裂殖	schizo-
裂脑人	commissurotomy
裂体吸虫	schistosome
裙裤	culottes
补品	tonic
补炉	fettling
补花	applique
补选	by-election
补遗	addendum
装饰品	ornament
里边	inside
裲	waistcoat
裸地化	denudation
裸体	naked
裸体主义	nudism
裸体主义者	nudist
制造者	maker
褂	gown
复印件	photocopy
复印机	photocopier
复本	copy
复杂	complicated
复杂性	complexity
褥疮	bedsore
裤腰带	waistband
襚	grave-clothes
襟怀夷旷	broad-minded
裆部	crotch
袜带	garter
衬垫	pad
衬裙	petticoat
衬里	lining
衬裤	underpants
衬页	endpaper
袭击者	attacker
西	west
西乃	Sinai
西伯利亚	Siberia
西北	northwest
西南	southwest
西坡拉	Zipporah
西城区	Xicheng
西拉雅族	Siraya
西敏	Westminster
西柚	grapefruit
西洋人	Westerner
西洋杉	cedar
西洋棋	chess
西洛赛宾	psilocybin
西班牙	Spain
西班牙港	Port-of-Spain
西米	sago
西红柿	tomato
西葫芦	zucchini
西兰花	broccoli
西西弗斯	Sisyphus
西西里岛	Sicily
西里西亚	Silesia
西雅图	Seattle
要不得	intolerable
覆灭	destruction
覆盆子	raspberry
覆盖物	mulch
覆盖率	coverage
见不得人	shameful
见习员	trainee
觃口	Yankou
规则性	regularity
规划人员	planner
规律性	regular
规程	rules
觅食行为	foraging
视	literary
视力	eyesight
视差	parallax
视网膜	retina
视频	video
覗	peek
亲子丼	oyakodon
亲爱精诚	camaraderie
亲昵	intimate
亲水性	hydrophilic
亲眷	relatives
亲美	pro-U.S.
亲肤	skin-friendly
观光客	tourist
观察者	observer
观测台	observatory
观众	spectators
观音	Guanyin
观鸟	birdwatching
角妓	courtesan
角质素	keratin
角锥	pyramid
角斗士	gladiator
角龙	ceratopsian
解剖刀	scalpel
解剖学	anatomy
解毒剂	antidote
解码器	decoder
解酸药	antacid
触手	tentacle
触技曲	toccata
触控屏	touchscreen
触毛	vibrissa
触肢	pedipalp
言下之意	implication
言而无信	untrustworthy
订书针	staple
订购者	subscriber
讣告	obituary
计分卡	scorecard
计数率仪	ratemeter
计时器	timer
计步器	pedometer
计程车	cab
计策	stratagem
讨人厌	horrid
讨喜	endearing
训练者	trainer
讪脸	impudent
记帐员	bookkeeper
记法	notation
记录员	recorder
讶	astounded
讼	litigation
访客	visitor
许字	betrothed
诉讼	lawsuit
诊所	clinic
注脚	footnote
诈骗罪	fraud
𫍡	cheat
评书	pingshu
评级	rating
评论员	commentator
评鉴	evaluation
词人墨客	wordsmith
词位	lexeme
词典学	lexicography
词素	morpheme
咏叹调	aria
询盘	inquiry
试剂	reagent
试金	assay
试验性	experimental
诗律	prosody
诗词	verse
诠释学	hermeneutics
话痨	chatterer
话语权	influence
该亚	Gaea
详备	detailed
詹森	Johnson
认识不能	agnosia
诱人	attractive
诱拐者	abductor
诱变剂	mutagen
诱饵	bait
语句	sentence
语境	context
语汇	vocabulary
语意性	semantic
语数外	Chinese
语料库	corpus
语法	grammar
语源	etymology
语用学	pragmatics
语义学	semantics
语言学	linguistics
语言学家	linguist
语音学	phonetics
诚信	honesty
诚实	honest
诚心	sincerity
诫命	commandment
误区	misconceptions
说不出话来	speechless
说服力	persuasiveness
说谎者	liar
课外	extracurricular
课室	classroom
谇	abuse
诽	slander
调光器	dimmer
调制	modulation
调制解调器	modem
调味肉汁	gravy
调查人员	investigator
调节器	regulator
调色盘	palette
调药刀	spatula
调酒师	bartender
谈性色变	prudish
请坐	please
请愿书	petition
论法	argumentation
论著	treatise
论题	topic
咨询员	advisor
诸柘	sugarcane
谚文	hangul
谚语	proverb
诺亚	Noah
诺夫哥罗德	Novgorod
诺曼底	Normandy
诺言	promise
谋杀罪	murder
谜	riddle
谜样	enigmatic
谦	modest
谦卑	humble
讲辞	lectures
谢忱	gratitude
证人	witness
证券经纪人	stockbroker
证实礼	confirmation
证词	testimony
𫍢	wrangling
识别码	identifier
识文断字	literate
谱系	pedigree
警句	aphorism
警官	constable
警察	police
警笛	siren
谵妄	delirium
议事日程	agenda
护士	nurse
护栏	guardrail
护理学	nursing
护目镜	goggles
护肤	skincare
护卫舰	frigate
护身符	amulet
读写能力	literacy
读法	pronunciation
读者	reader
变化无常	fickle
变压器	transformer
变流器	converter
变现能力	liquidity
变装者	cross-dresser
变调夹	capo
谶语	prophecy
谷地	valley
谷歌	Google
豆瓣	Douban
豆豆帽	beanie
豆类	bean
竖琴	harp
丰台区	Fengtai
丰度	abundance
丰硕	plentiful
丰裕	well-off
象征主义	symbolism
象虫	weevil
豪宅	mansion
豪华	luxurious
豪言壮语	bold
豪猪	porcupine
猪倌	swineherd
猪场	piggery
猪栏	pigsty
猪油	lard
猪肉	pork
貌	looks
猫咪	kitty
猫声鸟	catbird
猫腻	shenanigans
猫薄荷	catnip
猫雾族	Babuza
猫头鹰	owl
貘	tapir
贝塔斯曼	Bertelsmann
贝宁	Benin
贝拉	Beira
贝拉米	Bellamy
贝斯	Bes
贝氏体	bainitic
贝尔格莱德	Belgrade
贝尔法斯特	Belfast
贝纳通	Benetton
贝鲁特	Beirut
贞	chaste
贞洁	chastity
负担者	bearer
负累	burden
财务秘书	treasurer
财阀	tycoon
贡品	tribute
贡布	Kampot
贫穷潦倒	destitute
贫血	anemia
货仓	warehouse
货品	goods
货币主义	monetarism
贩子	trafficker
贪吃	gluttonous
贪心	greedy
贪污腐败	corruption
贯时	diachronic
贮水处	reservoir
贮物	storage
贵妇人	dame
贵妇犬	poodle
贵族社会	aristocracy
买主	customer
买家	buyer
买办	comprador
费利克斯	Felix
费卢杰	Fallujah
贴纸	sticker
贺拉斯	Horace
资本主义	capitalism
资本家	capitalist
资费	postal
资金	funds
贾第虫病	Giardiasis
宾利	Bentley
宾夕法尼亚	Pennsylvania
宾得	Pentax
赔偿金	compensation
贤明	sagacious
卖家	seller
质粒	plasmid
账单	bill
赌场	casino
赌徒	gambler
购物	shopping
购买者	purchaser
赛力斯	Seres
赛德克族	Seediq
赛德娜	Sedna
赛轮思	Cerence
赜	mysterious
赘肉	flab
赘余	superfluous
赠款	grant
赠礼	present
赠与者	giver
赞助商	sponsor
赞比亚	Zambia
赞西佩	Xanthippe
赞辞	praise
赃	loot
赎金	ransom
赤睛鱼	rudd
赤脚	barefoot
赤藓糖醇	erythritol
赤贫	poverty-stricken
赫耳墨斯	Hermes
赭	ocher
走扁带	slacklining
起初	originally
起床号	reveille
起落架	undercarriage
起诉员	prosecutor
起诉者	plaintiff
超人	Superman
超升	exaltation
超售	overbooking
超商	mini-mart
超媒体	hypermedia
超对称	supersymmetry
超导	superconductivity
超我	superego
超敏反应	hypersensitivity
超文本	hypertext
超新星	supernova
超模	supermodel
超泛神论	panentheism
超然	aloof
超现实	surreal
超现实主义	surrealism
超短裙	miniskirt
超级市场	supermarket
超级英雄	superhero
超级计算	supercomputing
超级计算机	supercomputer
超能力	superpower
超临界	supercritical
超自然	supernatural
超越主义	transcendentalism
超链接	hyperlink
超音速	supersonic
超频	overclocking
越南	Vietnam
越式	Vietnamese-style
赵国	Zhao
趣剧	farce
趋势	trend
足够	enough
趺	instep
趾尖	tiptoe
趿拉儿	babouche
跂訾	opinionated
跌打药	liniment
跑者	runner
跑马场	racecourse
跕	shuffle
跗猴	tarsier
跟踪狂	stalker
迹线	trajectory
跣	barefooted
跨境	cross-border
跨学科	interdisciplinary
跨性别	transgender
跨文化	intercultural
跨省	interprovincial
路旁	roadside
路易斯安那	Louisiana
路桩	bollard
路环	Coloane
路缘	curb
跳弹	ricochet
跳蚤	flea
跽	kneel
踆	squat
踊	leap
踏雪板	snowshoe
踢拳	kickboxing
踩镲	hi-hat
蹄印	hoofprint
蹇运	misfortune
跖骨	metatarsus
蹢	hoof
踪	trace
蹦床	trampoline
蹴鞠	cuju
跷跷板	see-saw
躁狂	manic
身心爽快	refreshment
身心障碍	disability
身手敏捷	agile
身披羽毛	feathered
身躯	body
躲避球	dodgeball
车床	lathe
车库	garage
车载	onboard
车辆	vehicle
车轮	wheel
车驾	carriage
军事化	militarization
军事法庭	court-martial
军国主义	militarism
军方	military
军火库	arsenal
军号	bugle
军需官	quartermaster
软文	advertorial
软木	cork
软毛	fur
软甲纲	Malacostraca
软骨	cartilage
软体动物	mollusk
轴突	axon
轴距	wheelbase
较好	better
载荷	load
载货汽车	truck
挽诗	elegy
辅修	minor
辅音	consonant
轻信	gullible
轻慢	irreverent
轻手轻脚	quietly
轻染	tinge
轻狂	frivolous
轻轻	lightly
轻量	lightweight
辉瑞	Pfizer
轮椅	wheelchair
轮渡	ferry
轮状病毒	rotavirus
轮盘赌	roulette
轮胎	tire
轮毂罩	hubcap
轮转机	merry-go-round
输尿管	ureter
辐射	radiation
辐射分解	radiolysis
辐射敏感性	radiosensitivity
辐射计	radiometer
辐照	irradiation
转动件	rotor
转瞬即逝	transitory
轑	spokes
轰击	bombard
辔头	bridle
辛伐他汀	simvastatin
辛劳	laborious
辛勤	hardworking
辛辛那提	Cincinnati
辣子鸡	laziji
辣根	horseradish
辣椒素	capsaicin
办公室	office
办公桌轮用	hot-desking
辨识度	distinctiveness
辞海	Cihai
农人	farmer
农场	farm
农奴	serf
农家庭院	farmyard
农旅	agritourism
农业生技	agri-biotechnology
农民	peasant
农民阶级	peasantry
农舍	farmhouse
农艺	agronomy
迂气	pedantry
迂远	impractical
近乎同步	plesiochronous
近在眼前	imminent
近义词	near-synonym
近处	nearby
近亲繁殖	inbreeding
迦太基	Carthage
迪士尼乐园	Disneyland
迪拜	Dubai
迪斯科吧	discotheque
迫切	urgent
迫切性	urgency
回旋处	rotary
回旋镖	boomerang
回旋余地	leeway
迷乱	confusion
迷你剧	miniseries
迷彩	camouflage
迷蒙	misty
迷踪罗汉拳	Mizongyi
迷阵	maze
迷离惝恍	confusing
追悼文	eulogy
追星族	stan
退伍军人	veteran
退关	shut-out
逃亡者	runaway
逆喻	oxymoron
逆龄	anti-aging
透明程度	transparency
透水性	permeability
透红	rosy
逐行	progressive
途径	way
迳向	radial
逗人喜爱	cute
逗点	comma
这些	these
这里	here
通勤	commuting
通古斯	Tungus
通心粉	macaroni
通情达理	sensible
通气会	briefing
通用串行总线	USB
通用性	universality
通行税	toll
通货紧缩	deflation
通货膨胀	inflation
通量	flux
通关密语	password
通关文牒	passport
速射	rapid-fire
速度计	speedometer
速记	shorthand
速记员	stenographer
造句	sentence-making
造林	forestation
造纸	papermaking
造船	shipbuilding
造船所	shipyard
连字符	hyphen
连忙	promptly
连招	combo
连指手套	mittens
连接器	connector
连接酶	ligase
连枷	flail
连歌	renga
连滚带爬	scrambling
连绵不绝	unending
连续性	continuity
连续体	continuum
连翘	Forsythia
连词	conjunction
连体裤	jumpsuit
周末	weekend
进度表	schedule
进步主义	progressivism
进深	depth
进程	process
进阶	advanced
逸乐	pleasure-seeking
遇难船	shipwreck
游侠	knight-errant
游吟诗人	troubadour
游戏王	Yu-Gi-Oh!
游乐场	playground
游艺	entertainment
运动学	kinematics
运动服	sportswear
运动鞋	sneakers
运河	canal
过度医疗	overtreatment
过敏原	allergen
过于	excessively
过氧化物	peroxide
过街天桥	skywalk
过载	overload
过量	excessive
过头话	exaggeration
道卡斯族	Taokas
道奇	Dodge
道德家	Daoist
道拉吉里峰	Dhaulagiri
道听途说	gossip
道馆	dojo
达喀尔	Dakar
达尼亚	Dania
达拉斯	Dallas
达尔富尔	Darfur
达尔马提亚	Dalmatia
违宪	unconstitutional
违禁品	contraband
违者	violator
遥测	telemetry
遥远	distant
递质	neurotransmitter
远地点	apogee
远端转移	metastasis
远距离	long-distance
适意	agreeable
适老化	elder-accessible
适配	adaptation
迟了	late
迟滞现象	hysteresis
迁居移民	immigration
选举权	suffrage
选集	anthology
遗传率	heritability
遗尿	bed-wetting
遗物	remnant
辽	faraway
辽宁号	Liaoning
避孕	contraception
避弹坑	foxhole
避役	chameleon
避蚊胺	DEET
迈巴赫	Maybach
边境	frontier
边框	frame
邋遢	unkempt
逻	patrol
那些	those
那里	there
邦	nation
邦联	confederation
邵族	Thao
郊区	outskirts
郛	suburbs
郡治安官	sheriff
部件	part
部落	tribe
邮差	postman
邮戳	postmark
邮袋	mailbag
邮费	postage
邮递员	mailman
都市	city
都柏林	Dublin
乡下习气	provincialism
邓迪	Dundee
邻人	neighbor
酊剂	tincture
配偶	spouse
配子	gamete
配称	worthy
配镜师	optician
配餐	catering
配体	ligand
酐	anhydride
酒廊	bar
酒浆	wine
酒精饮料	liquor
酒庄	winery
酒蒙子	alcoholic
酒鬼	drunkard
酗	drunk
酚	phenol
酚酞	phenolphthalein
酣	intoxicated
酥油	butter
酩酊大醉	plastered
酮	ketone
酮糖	ketose
酯	ester
酯化	esterification
酯酶	esterase
酵母菌	yeast
酵母醇	zymosterol
酵素	enzyme
酵解作用	zymolysis
酷炫	awesome
酸奶	yogurt
酸性	acidity
酸辛	misery
酸黄瓜	pickle
醉意	tipsiness
醋栗	gooseberry
醚	ether
醛	aldehyde
醛固酮	aldosterone
醛糖	aldose
丑怪	grotesque
丑闻	scandal
丑陋	ugly
医师	doctor
医患	doctor-patient
酱料	sauce
醯	acyl
酿造学	zymurgy
释名	"Shiming"
里加	Riga
里弗赛德	Riverside
里斯本	Lisbon
里昂	Lyon
里瓦尔多	Rivaldo
里程碑	milestone
里程表	odometer
重力	gravity
重商主义	mercantilism
重婚	bigamy
重新统一	reunification
重新装修	refurbishment
重新造林	reforestation
重碳酸盐	bicarbonate
重要	important
重要性	importance
重复性	repetitive
野兔	hare
野外定向	orienteering
野禽	fowl
野蛮人	barbarian
量子	quantum
量身定制	tailor-made
厘克	centigram
厘升	centiliter
厘米	centimeter
金光闪烁	spangle
金刚狼	Wolverine
金刚总持	Vajradhara
金刚萨埵	Vajrasattva
金刚鹦鹉	macaw
金匠	goldsmith
金合欢	acacia
金桔	kumquat
金枪鱼	tuna
金瓜石	Jinguashi
金石学	epigraphy
金秋	fall
金丝燕	Aerodramus
金丝雀	canary
金融家	financier
金酒	gin
金银块	bullion
金银花	honeysuckle
金钱豹	leopard
金钟	Admiralty
金鱼	goldfish
金龟子	scarab
钌铞儿	hasp
钉书机	stapler
钉耙	rake
钉螺	Oncomelania
钉钉	DingTalk
针剂瓶	ampoule
针孔	pinhole
针扎	pincushion
针法	stitch
针状	needle-shaped
针织品	knitwear
针叶树	conifer
钓客	angler
扣眼	buttonhole
钒钾铀矿石	carnotite
钙质	calcium
钶	columbium
钹	cymbals
铂金	platinum
铆钉	rivet
铅垂线	plumbline
钩子	hook
钩头篙	boathook
𬬸	acmite
银保	bancassurance
银匠	silversmith
银器	silverware
银杏	ginkgo
银莲花	anemone
银行家	banker
银行业	banking
铜匠	coppersmith
铜锈	verdigris
铜锈层	patina
铜锣	gong
铭文	inscription
铭瑄	MaxSun
铵	ammonium
销势	sale
铝土矿	bauxite
铤	ingot
锃亮	shiny
铺位	bunk
铺板	bedboard
铺盖卷儿	bedroll
锆合金	zircaloy
锯木厂	sawmill
锯末	sawdust
锯齿	sawtooth
钢枪	rifle
钢片琴	celesta
钢琴师	pianist
钢锯	hacksaw
钢铁	steel
锥形	conical
锥虫病	trypanosomiasis
锦缎	brocade
锚	anchor
锡克	Sikh
锡克教	Sikhism
锡安	Zion
锡瓦	Siwa
锡箔	tinfoil
锡金	Sikkim
锨	shovel
锅炉	boiler
镀银	silver-plated
鍏	spade
键帽	keycap
键盘	keyboard
鎉	thallium
锁匠	locksmith
锁孔	keyhole
蓥	polish
铠甲	armor
镐头	pickaxe
镇区	township
镇痛药	analgesic
镇纸	paperweight
镇静剂	tranquilizer
镇静药	sedative
链子	chain
链结	linkage
链路	link
链轮	sprocket
鏊子	griddle
镆铘	Moye
铲运机	carry-scraper
铲雪车	snowplow
镜片	lens
𬭸	phosphonium
𨱑	bell
𫔍	vanadium
钟乳石	stalactite
钟摆	pendulum
钟乐	bells
钟表盘	clockface
铁人	Ironman
铁人三项	triathlon
铁板烧	teppanyaki
铁琴	metallophone
铁砧	anvil
铁锈	rust
铁青	ashen
铁齿	argumentative
钥匙卡	keycard
钥匙链	keychain
镊子	tweezers
銮	imperial
钃	metal
长宽	size
长崎	Nagasaki
长度	length
长弓	longbow
长方形	rectangle
长方体	cuboid
长期性	long-term
长板	longboard
长条	strip
长椅	bench
长生不死	immortality
长统袜	stockings
长老会	Presbyterianism
长号	trombone
长裤	trousers
长钉	spike
长靴	boot
长颈瓶	flask
长颈龙	tanystropheus
门垫	doormat
门外汉	layman
门岗	gate
门径	access
门挡	doorstop
门柱	doorpost
门牙	incisor
门铃	doorbell
门头沟区	Mentougou
闪光	flash
闪光弹	flashbang
闪卡	flashcard
闪回	flashback
闪米特	Semitic
闪辉	scintillation
闪闪	flickering
闭会祈祷	benediction
开创性	innovative
开放性	openness
开发者	developer
开罗	Cairo
开车族	motorists
开通	open-minded
闲暇	leisure
间作	interplanting
间接	indirect
间脑	diencephalon
间谍	spy
间谍软件	spyware
阂	obstruct
阅读障碍	dyslexia
阍	doorkeeper
阈值	threshold
关岛	Guam
关节炎	arthritis
关键字	keyword
阮	ruan
防伪	anti-counterfeiting
防冻	antifreeze
防守者	defender
防弹	bulletproof
防水	waterproof
防火墙	firewall
防火道	firebreak
防特	counterespionage
防磁	antimagnetic
防避	protection
防骇	anti-hacker
阻尼	damping
阿佛洛狄忒	Aphrodite
阿修罗	Asura
阿伦	Aalen
阿克拉	Accra
阿利坎特	Alicante
阿加迪尔	Agadir
阿卡	Acre
阿卡普尔科	Acapulco
阿塞拜疆	Azerbaijan
阿多尼斯	Adonis
阿奶	granny
阿姆斯特丹	Amsterdam
阿宅	homebody
阿富汗	Afghanistan
阿布哈兹	Abkhazia
阿布贾	Abuja
阿弥陀如来	Amitabha
阿得莱德	Adelaide
阿拉	me
阿拉丁	Aladdin
阿拉巴马	Alabama
阿拉摩	Alamo
阿拉斯	Arras
阿拉斯加	Alaska
阿拉木图	Almaty
阿拖品化	atropinization
阿斯塔纳	Astana
阿斯马拉	Asmara
阿明	Al-Amin
阿曼	Oman
阿月浑子	pistachio
阿根廷	Argentina
阿森	Assen
阿比西尼亚	Abyssinia
阿洛菲	Alofi
阿尔卡特	Alcatel
阿尔及利亚	Algeria
阿尔及利亚人	Algerian
阿尔及尔	Algiers
阿尔巴尼亚	Albania
阿尔梅里亚	Almería
阿尔萨斯	Alsace
阿特兰蒂斯	Atlantis
阿瓦鲁阿	Avarua
阿皮亚	Apia
阿维拉	Avila
阿肯色	Arkansas
阿兹特克	Aztec
阿蒙	Amun
阿萨姆	Assam
阿兰文	Aramaic
阿西吧	aw
阿里巴巴	Alibaba
阿非利加	Africa
阿鲁巴	Aruba
陀螺仪	gyroscope
附加物	complement
附加费	surcharge
附笔	postscript
附肢	appendage
附录	appendix
陌生人	stranger
陌陌	Momo
降肾上腺素	noradrenalin
降落伞	parachute
降血钙素	calcitonin
限制级	R-rated
陕南	Shannan
陕甘宁	Shaanxi
陡峭	precipitous
阵风	gust
除湿器	dehumidifier
除臭剂	deodorant
陪审员	juror
陪审团	jury
阴囊	scrotum
阴屁	queef
阴沉	gloomy
阴茎	penis
阴蒂	clitoris
阴道	vagina
阴部	genitalia
阴霾	haze
陈迹	vestiges
陶匠	potter
陆基	land-based
陆战队	marines
陆军上校	colonel
陆军中尉	lieutenant
陆龟	tortoise
阳伞	parasol
阳光房	sunroom
阳极	anode
隅	corner
隆隆	rumble
陧	dangerous
队友	teammate
队形	formation
阶级式	hierarchical
隔板	divider
隔音	soundproofing
隘谷	ravine
隘路	defile
隙缝	aperture
障眼法	smokescreen
隞	Ao
隧道	tunnel
随同	accompanying
随机应变	pragmatic
随行人员	entourage
险滩	shoals
隐	hidden
隐修	monasticism
隐喻	metaphor
隐士	hermit
隐写术	steganography
隐形	invisible
隐栖动物学	cryptozoology
隐睾	cryptorchidism
隐约	vague
隐袭	insidious
隐隐约约	faintly
隐隐绰绰	faint
隶圉	servants
雀巢	Nestlé
雀斑	freckles
雄厚	substantial
雄性	male
雄鸡	rooster
雄鹰	tercel
雅	elegant
雅典	Athens
雅典娜	Athena
雅利安	Aryan
雅加达	Jakarta
雅威	Yahweh
雅恩德	Yaounde
雅气	elegance
雅温得	Yaoundé
雅尔塔	Yalta
雅穆索戈	Yamoussoukro
雅罗鱼	dace
雅虎	Yahoo
雅马哈	Yamaha
集中器	concentrator
集市	market
集约	intensive
集镇	town
集韵	Jiyun
集体主义	collectivism
雇主	employer
雌三醇	estriol
雌性	female
雌性激素	estrogen
雌狮	lioness
雌蕊	pistil
雌雄同体	hermaphrodite
雌雄同体性	hermaphroditism
雌鹿	doe
雍正	Yongzheng
雕刻品	sculpture
雕刻家	sculptor
双元音	diphthong
双光气	diphosgene
双唑泰栓	metronidazole
双城子	Shuangchengzi
双峰	boobies
双拐	crutches
双曲线	hyperbola
双极	bipolar
双氢睾酮	dihydrotestosterone
双球菌	diplococcus
双稳	bistable
双筒望远镜	binoculars
双管	double-barreled
双节棍	nunchaku
双翼飞机	biplane
双肩包	backpack
双规	shuanggui
双语	bilingual
双轨	double-track
双边	bilateral
双重	double
双陆棋	backgammon
双双	both
双音节	bisyllable
双体船	catamaran
雏菊	daisy
杂技演员	acrobat
杂草	weeds
杂讯	interference
杂货商	grocer
杂质	impurity
杂食动物	omnivore
鸡奸	sodomy
鸡枞	macrolepiota
离子	ion
离岸	offshore
离心机	centrifuge
离散性	discreteness
离谱	inappropriate
难以置信	incredible
难伺候	high-maintenance
难吃	unpalatable
难忘	unforgettable
难民	refugee
难为情	embarrassed
难处	trouble
难点	difficulty
雨具	rainwear
雨凇	verglas
雨林	rainforest
雨水	rainwater
雨滴	raindrop
雨量	rainfall
雪佛兰	Chevrolet
雪地车	snowmobile
雪套	gaiters
雪崩	avalanche
雪岳山	Seoraksan
雪景	snowscape
雪球	snowball
雪花	snowflake
雪茄烟	cigar
雪貂	ferret
云吞	wonton
云杉	spruce
云母	mica
云头	cloud
零散	scattered
零点五	0.5
雷恩	Rennes
雷暴	thunderstorm
雷声	thunder
雷阵雨	thundershower
雹	hail
雹块	hailstone
雹暴	hailstorm
电位计	potentiometer
电信	telecommunications
电化学	electrochemistry
电匠	electrician
电报机	telegraph
电压	voltage
电压表	voltmeter
电子人	cyborg
电子商务	e-commerce
电子学	electronics
电容	capacitance
电容器	capacitor
电影剧本	screenplay
电影制作	filmmaking
电感	inductance
电抗	reactance
电极	electrode
电气化	electrification
电泳	electrophoresis
电流表	ammeter
电瓶	accumulator
电疗	electrotherapy
电磁	electromagnetic
电磁学	electromagnetism
电磁铁	electromagnet
电筒	flashlight
电臀舞	twerking
电解质	electrolyte
电负性	electronegativity
电阻器	resistor
电离层	ionosphere
电震	electroshock
霅	rain
震波图	seismogram
震耳	ear-splitting
震耳欲聋	deafening
霉菌毒素	mycotoxin
霍乱	cholera
霍尔木兹	Hormuz
霍顿	Hotton
霜白	frosty
雾件	vaporware
雾化器	nebulizer
雾蒙蒙	foggy
霰弹枪	shotgun
霰粒肿	chalazion
露珠	dewdrop
露肩	shoulder-baring
露背	halterneck
露西	Lucy
霸权主义	hegemonism
霹雳舞	breakdancing
灵活性	flexibility
灵车	hearse
灵魂伴侣	soulmate
青光眼	glaucoma
青年期	adolescence
青睐	favor
青紫	purple
青草	grass
青釉	celadon
青霉素	penicillin
靛青	indigo
静力学	statics
静心	meditation
静脉	vein
非人化	dehumanization
非利士地	Philistia
非动物性	inanimacy
非均质	inhomogeneous
非写实	nonrepresentational
非对称	asymmetric
非小说	non-fiction
非层状	unstratified
非必需	inessential
非政府	non-governmental
非数字	non-numeric
非暴力	nonviolent
非核	non-nuclear
非核化	denuclearization
非正式	unofficial
非法	illegal
非独立	dependent
非递推	nonrecursive
非遗传多型性	polyphenism
非零	nonzero
非预谋	unpremeditated
非高峰	off-peak
非党	non-party
靡烂	rotting
面向连接	connection-oriented
面无人色	ashen-faced
面纱	veil
面纸	kleenex
面色	complexion
靥	dimple
革命性	revolutionary
靴子	boots
靶子	target
鞋套	overshoe
鞋子	shoe
鞋履	footwear
鞋拔	shoehorn
鞘脂	sphingolipid
鞭毛	flagellum
鞭毛纲	flagellate
鞭虫	whipworm
鞹	leather
缰绳	reins
韦伯	Webb
韦尔瓦	Huelva
韦科	Waco
韦驮菩萨	Skanda
韧劲	tenacity
韧带	ligament
韧性	toughness
韧皮部	phloem
韧体	firmware
韨	kneepad
韩国泡菜	kimchi
韩国街	Koreatown
韩式	Korean-style
韖	tan
韫	contain
韭	leek
音乐学	musicology
音乐家	musician
音系学	phonology
响亮	resounding
响尾蛇	rattlesnake
响音	sonorant
页岩	shale
顶级	top-notch
頄	cheekbone
顺利	smoothly
顺化	Hue
顺性别	cisgender
顺时针	clockwise
顺磁	paramagnetic
顺义区	Shunyi
顼顼	frustrated
颂歌	carol
预先	beforehand
预报	forecast
预定义	predefined
预后	prognosis
预应力	prestressed
预收费	prepayment
预算	budget
预言家	prophet
预试	pretest
顽皮	naughty
顽童	urchin
顿涅茨克	Donetsk
顿首	kowtow
頖	disperse
领主	suzerain
领事	consul
领事馆	consulate
领土	territory
领域	domain
领导者	leader
领航员	navigator
领诺	consent
领头羊	bellwether
头倒立	headstand
头向前	headlong
头戴式耳机	headphones
头晕	dizzy
头晕目眩	dazzled
头朝下	headfirst
头枕	headrest
头梳	comb
头疼	headache
头皮	scalp
头皮屑	dandruff
头盔	helmet
头胸部	cephalothorax
头脑风暴	brainstorming
头足纲	Cephalopoda
头铁	headstrong
头骨	skull
颊	cheeks
颈部	neck
颈链	necklace
频仍	frequent
频率	frequency
题外话	digression
额头	forehead
颚部	jaw
颜值高	good-looking
顑	yellow
颠连	illogical
类人猿	hominid
类似点	resemblance
类固醇	steroid
类星体	quasar
类毒素	toxoid
类语辞典	thesaurus
类鼻疽	melioidosis
𫖹	frown
显微学	microscopy
显然	clearly
显示器	monitor
颅测量	craniometry
风挡	windshield
风格	style
风流倜傥	debonair
风湿	rheumatism
风笛	bagpipes
风筝冲浪	kitesurfing
风箱	bellows
风速计	anemometer
风险	risk
台风	typhoon
飓风	hurricane
飞地	enclave
飞盘	frisbee
飞秒	femtosecond
飞腿	kick
飞艇	airship
飞鹰	eagle
食人魔	ogre
食人鱼	piranha
食尸鬼	ghoul
食欲	appetite
食料	foodstuff
食槽	manger
食肉目	Carnivora
食腐动物	scavenger
食草动物	herbivore
食虫目	Insectivora
饮品	beverage
饮食疗养	diet
饲养者	feeder
饱和	saturated
养老金	pension
餐具	tableware
餐前酒	aperitif
餐后酒	digestif
餐牌	menu
餐食	meal
余下	remaining
余存	remainder
余烬	ember
馅	filling
餩	hiccup
餲	sour
馐	delicacies
饐	rancid
饶有兴趣	engrossing
饕客	gourmand
馋痨	gluttony
馕坑	tandoor
馕饼	naan
首字母缩写	acronym
首秀	debut
香吻	kiss
香巴拉	Shambhala
香氛	fragrance
香港众志	Demosistō
香滑	creamy
香熏	aroma
香酥	crisp-fried
马但	Matthan
马来亚	Malaya
马来西亚	Malaysia
马克思主义	Marxism
马克思列宁主义	Marxism-Leninism
马其顿	Macedonia
马具	harness
马列毛	Marx
马力	horsepower
马匹	horse
马可尼	Marconi
马塞卢	Maseru
马尼拉	Manila
马尾辫	ponytail
马屁精	sycophant
马厩	stable
马德望	Battambang
马德里	Madrid
马戏团	circus
马拉博	Malabo
马拉维	Malawi
马拉开波	Maracaibo
马斯喀特	Muscat
马斯特里赫特	Maastricht
马朱罗	Majuro
马槟榔	caper
马氏体	martensitic
马球	polo
马穆楚	Mamoudzou
马粪纸	strawboard
马约特	Mayotte
马耳他	Malta
马萨诸塞	Massachusetts
马蜂	hornet
马褡子	saddle-bag
马趴	face-plant
马蹄铁	horseshoe
马达加斯加	Madagascar
马里	Mali
马里博尔	Maribor
马里兰	Maryland
马铃薯	potato
马面	Horse-Face
马鞍	saddle
马鞭	horsewhip
马骡	mule
马龙派	Maronites
驰名	famous
驯鹿	reindeer
驳船	barge
驹	colt
驾帆船	sailing
驾驶人	car
驾驶员	pilot
驾驶室	wheelhouse
驼子	hunchback
骆马	llama
駽	gray
騋	mare
骑兵	cavalry
骑士气概	chivalry
骑士风格	knighthood
腾格里	Tengri
腾讯	Tencent
骚驴	jackass
驱动器	drive
验光师	optometrist
验光法	optometry
验尸官	coroner
验电器	electroscope
惊人	astonishing
惊心动魄	hair-raising
惊愕	stupefied
惊异	amazed
惊险	perilous
骤雨	shower
骨	bone
骨子里	fundamentally
骨感	bony
骨片	spicule
骨病	osteopathy
骨瘦如柴	emaciated
骨盆	pelvis
骨坛	urn
骨质疏松	osteoporosis
骨关节炎	osteoarthritis
骭	shinbone
骰子	dice
髁	condyles
脏字	obscenity
脏辫	dreadlocks
脏脏	dirty
体位	posture
体势	feature
体弱	debility
体性	disposition
体操运动员	gymnast
体育场馆	gymnasium
体育运动	sports
体魄	physique
体鸣乐器	idiophone
高光时刻	highlight
高利贷	usury
高危	high-risk
高大	tall
高技术	high-tech
高斯	gauss
高卢	Gaul
高矗	towering
高祖母	great-great-grandmother
高祖父	great-great-grandfather
高端	high-end
高腔	gaoqiang
高脚杯	goblet
高脚椅	stool
高通公司	Qualcomm
高速公路	expressway
高铁血红蛋白	methemoglobin
高雄	Kaohsiung
高靿	high
高音喇叭	tweeter
高龄	elderly
髭	mustache
发型	hairstyle
发型设计师	hairstylist
发带	headband
发簪	hairpin
发网	hairnet
发蜡	pomade
发辫	braid
鬃毛	mane
松泛	relaxed
须后水	aftershave
鬣狗	hyena
鬣蜥	iguana
斗牛	bullfighting
斗鸡眼	cross-eye
闹区	downtown
闹鬼	haunted
郁塞	pent-up
郁金香	tulip
郁郁寡欢	cheerless
郁郁葱葱	lush
鬼鬼祟祟	secretive
鬼魂	ghost
魂	soul
魅力四射	glamorous
魏玛	Weimar
魑魅	demons
魔像	golem
魔王撒旦	Satan
魔术师	magician
魔术贴	velcro
魔都	Modu
魔鬼	devil
鱼刺	fishbone
鱼叉	harpoon
鱼塘	fishpond
鱼子酱	caviar
鱼尾	fishtail
鱼种	fingerling
鱼贩	fishmonger
鱼钩	fishhook
鱼雷	torpedo
鱼类	fishes
鱼类学	ichthyology
鱼饼	fishcake
鱼香	yuxiang
鱼龙	ichthyosaur
魣鱼	perch
鲁凯族	Rukai
鲁棒性	robustness
鲁莽	hot-headed
鱿鱼	squid
魾	Bagarius
𫚖	fish
鲌	culter
鲉	scorpionfish
鲖	snakefish
鲜味	umami
鲜橙多	Xianchengduo
鲜血	blood
鲜艳	bright-colored
鲤鱼	carp
鲤鱼旗	koinobori
鲨鱼	shark
鲻	mullet
鲯鳅	mahi-mahi
鲭鱼	mackerel
鲷鱼烧	taiyaki
鲴	Xenocypris
鲱鱼	herring
鲸	whale
鲸豚	cetacean
鲶鱼	catfish
鳊	bream
𫚢	mudfish
鳏	widower
鳍	fin
鳍状肢	flipper
鳁	sardine
鲣	bonito
鳗鱼	eel
鳟鱼	trout
鳄	crocodile
鳄梨酱	guacamole
鳄龙	Champsosaurus
鸟儿	bird
鸟嘴	beak
鸟屋	birdhouse
鸟澡盆	birdbath
鸟疫	ornithosis
鸟笼	birdcage
鸟羽	pinion
鸟脚下目	Ornithopoda
鸟类	birds
鸠鸽	dove
凤凰	phoenix
凤凰号	Phoenix
凤梨释迦	atemoya
鸣鸟	songbird
鸢尾	Iricdaceae
鸦	crow
鸵鸟	ostrich
鸭嘴兽	platypus
鸸鹋	emu
鸻	plover
鸽	pigeon
鵀	hoopoe
鹃形目	Cuculiformes
鹆	mynah
鹁	woodpidgeon
鹈鹕	pelican
鹅膏蕈素	amanitin
鹌鹑	quail
鹊	magpie
鹜	duck
𬸣	soaring
鹤嘴锄	pickax
鶸	siskin
鹡鸰	wagtail
鷇	fledglings
鹧鸪	partridge
鹰嘴豆泥	hummus
鹭	heron
鹭鸶	egret
鸬鹚	cormorant
鹦鹉	parrot
碱	alkali
碱性	alkaline
盐度	salinity
盐田	saltpan
盐卤	brine
鹿	deer
鹿儿岛	Kagoshima
鹿特丹	Rotterdam
鹿肉	venison
麂	muntjac
麇	thronging
麑	fawn
麒麟菜	eucheuma
丽实	practical
丽魄	moon
麝香	musk
麝香草	thyme
麦加	Mecca
麦卡锡主义	McCarthyism
麦地那	Medina
麦德林	Medellín
麦肯锡	McKinsey
麦芽	malt
麦芽糊精	maltodextrin
麦芽糖醇	maltitol
麦角	ergot
麸质	gluten
面团	dough
面条	noodles
面粉	flour
面线	misua
面饼	flatbread
面点	pastry
麻布	sackcloth
麻溜	briskly
麻疹	measles
麻糬	mochi
麻醉学	anesthesiology
麻醉学者	anaesthesiologist
麻醉师	anaesthetist
麻醉药	anesthetic
麻醉药品	narcotic
麻黄碱	ephedrine
黄原酸盐	xanthate
黄嘌呤	xanthine
黄曲霉毒素	aflatoxin
黄浦区	Huangpu
黄疸	jaundice
黄绿	yellow-green
黄蜂	wasp
黄酮	flavone
黄铁矿	pyrite
黄饼	yellowcake
黄龙病	huanglongbing
黉	school
黎巴嫩	Lebanon
黎庶	populace
黎明	dawn
黏住	cling
黏土	clay
黏液	mucus
黏痰	phlegm
黏稠度	viscosity
黏糊糊	sticky
黑名单	blacklist
黑塞哥维那	Herzegovina
黑子	detractor
黑尿症	alkaponuria
黑手党	mafia
黑洞洞	pitch-dark
黑煤玉	jet
黑瘤	melanoma
黑线鳕	haddock
黑胶	vinyl
黑色	black
黑莓子	blackberry
黗	yellowish-black
默剧	pantomime
默默无闻	unrenowned
点头招呼	beckon
党八股	drab
党羽	henchmen
黯	dim
鼎盛期	heyday
鼓吹者	advocate
鼓手	drummer
鼓板	clapper-board
鼓膜	eardrum
鼓鼓的	bulging
鼠	mouse
鼠海豚	porpoise
鼠肚鸡肠	small-minded
鼠蹊	groin
鼬鼠	weasel
鼹鼠皮	moleskin
鼻	nose
鼻出血	nosebleed
鼻屎	booger
鼻息	breath
鼻涕	snivel
鼻渊	nasosinusitis
鼻炎	rhinitis
鼻烟盒	snuffbox
鼻疽	glanders
鼻窦炎	sinusitis
齇	rosacea
齐一	uniform
齿轮箱	gearbox
齿龈音	alveolar
龅牙	bucktooth
龈脓肿	gumboil
𱌶𱌹	buckteeth
龋齿性	caries-inducing
龙涎香	ambergris
龙舌兰酒	tequila
龙蒿	tarragon
龙虾	lobster
庞然大物	colossus
庞贝	Pompeii
庞杂	complex
龗	dragon
龟毛	fussy
龟甲万	Kikkoman
